,id,away_starting_pitcher,away_team_rating,away_starting_pitcher_adjustment,away_travel_adjustment,away_pregame_rating,away_chance_winning,home_starting_pitcher,home_team_rating,home_starting_pitcher_adjustment,home_travel_adjustment,home_pregame_rating,home_chance_winning
0,01_30_BAL_MIN_14,"Straily, Dan",1419,5,0,1424,0.31,"Berrios, Jose",1517,22,24,1563,0.69
1,01_30_CIN_STL_14,"Mahle, Tyler",1499,-23,0,1476,0.43,"Hudson, Dakota",1532,-29,24,1527,0.57
2,01_30_OAK_TOR_15,"Anderson, Brett",1517,3,0,1520,0.52,"Sanchez, Aaron",1485,-3,24,1506,0.48
3,01_30_TB_BOS_16,"Morton, Charlie",1534,11,2,1547,0.44,"Price, David",1541,21,26,1588,0.56
4,01_30_CLE_HOU_16,"Bieber, Shane",1549,-18,0,1531,0.42,"Peacock, Brad",1576,-16,24,1584,0.58
5,01_30_NYY_SF_16,"Happ, J.A.",1565,-8,0,1557,0.6,"Holland, Derek",1466,-5,24,1485,0.4
6,01_30_SD_WSH_16,"Lauer, Eric",1484,-11,0,1473,0.37,"Strasburg, Stephen",1531,9,24,1564,0.63
7,01_30_MIA_PHI_18,"Richards, Trevor",1430,2,0,1432,0.34,"Arrieta, Jake",1519,3,24,1546,0.66
8,01_30_DET_CHW_19,"Carpenter, Ryan",1446,-21,0,1425,0.41,"Lopez, Reynaldo",1454,8,24,1486,0.59
9,01_30_MIL_NYM_19,"Woodruff, Brandon",1529,-4,0,1525,0.46,"Syndergaard, Noah",1518,11,24,1553,0.54
10,01_30_LAA_KC_19,"Barria, Jaime",1501,13,0,1514,0.57,"Lopez, Jorge",1447,-10,24,1461,0.43
11,01_30_COL_ATL_19,"Gray, Jon",1511,-1,0,1510,0.43,"Foltynewicz, Mike",1515,21,24,1560,0.57
12,01_30_CHC_ARI_20,"Darvish, Yu",1523,-13,0,1510,0.48,"Godley, Zack",1514,-15,24,1523,0.52
13,01_30_PIT_LAD_21,"Musgrove, Joe",1495,3,0,1498,0.35,"Kershaw, Clayton",1565,12,24,1601,0.65
14,01_30_TEX_SEA_21,"Minor, Mike",1464,37,0,1501,0.46,"Leake, Mike",1507,-2,24,1529,0.54
15,01_31_TB_BOS_13,"Glasnow, Tyler",1535,-16,0,1519,0.4,"Sale, Chris",1539,30,24,1593,0.6
16,01_31_MIA_PHI_13,"Lopez, Pablo",1429,3,0,1432,0.36,"Eflin, Zach",1520,-15,24,1529,0.64
17,01_31_OAK_TOR_13,"Bassitt, Chris",1514,6,0,1520,0.54,"Thornton, Trent",1487,-15,24,1496,0.46
18,01_31_MIL_NYM_13,"Gonzalez, Gio",1530,-4,0,1526,0.5,"Matz, Steven",1516,-15,24,1525,0.5
19,01_31_COL_ATL_13,"Anderson, Tyler",1513,-11,0,1502,0.44,"Gausman, Kevin",1513,10,24,1547,0.56
20,01_31_SD_WSH_13,"Lucchesi, Joey",1487,-4,0,1483,0.44,"Hellickson, Jeremy",1528,-27,24,1525,0.56
21,01_31_DET_CHW_14,"Boyd, Matthew",1446,18,2,1466,0.47,"Lopez, Reynaldo",1454,8,26,1488,0.53
22,01_31_BAL_MIN_14,"Bundy, Dylan",1418,-2,0,1416,0.32,"Gibson, Kyle",1518,5,24,1547,0.68
23,01_31_LAA_KC_14,"Harvey, Matt",1498,-11,0,1487,0.55,"Bailey, Homer",1450,-20,24,1454,0.45
24,01_31_CIN_STL_14,"Gray, Sonny",1498,5,0,1503,0.41,"Flaherty, Jack",1534,9,24,1567,0.59
25,01_31_NYY_SF_16,"German, Domingo",1566,-15,0,1551,0.57,"Rodriguez, Dereck",1465,14,24,1503,0.43
26,01_31_PIT_LAD_16,"Williams, Trevor",1494,18,0,1512,0.38,"Hill, Rich",1566,10,24,1600,0.62
27,01_31_TEX_SEA_16,"Lynn, Lance",1469,2,0,1471,0.42,"Swanson, Erik",1502,-2,24,1524,0.58
28,01_31_CHC_ARI_16,"Quintana, Jose",1526,4,0,1530,0.5,"Weaver, Luke",1511,-5,24,1530,0.5
29,01_31_CLE_HOU_19,"Carrasco, Carlos",1549,2,0,1551,0.45,"Miley, Wade",1577,-14,24,1587,0.55
30,01_32_OAK_BOS_19,"Montas, Frankie",1513,7,-2,1518,0.44,"Rodriguez, Eduardo",1537,-3,24,1558,0.56
31,01_32_STL_WSH_19,"Wacha, Michael",1535,-3,-3,1529,0.44,"Corbin, Patrick",1529,19,24,1572,0.56
32,01_32_CIN_NYM_19,"Roark, Tanner",1497,-6,-3,1488,0.41,"Wheeler, Zack",1518,12,24,1554,0.59
33,01_32_SD_ATL_19,"Margevicius, Nick",1486,-1,-3,1482,0.42,"Soroka, Mike",1513,0,24,1537,0.58
34,01_32_COL_MIL_19,"Freeland, Kyle",1512,21,-3,1530,0.46,"Davies, Zach",1528,9,21,1558,0.54
35,01_32_HOU_MIN_19,"Verlander, Justin",1579,33,-3,1609,0.59,"Odorizzi, Jake",1519,4,24,1547,0.41
36,01_32_BAL_CHW_20,"Means, John",1417,12,-2,1427,0.42,"Banuelos, Manny",1456,3,24,1483,0.58
37,01_32_TB_KC_20,"Stanek, Ryne",1537,-17,-3,1517,0.53,"Keller, Brad",1448,21,24,1493,0.47
38,01_32_LAD_SF_21,"Maeda, Kenta",1567,-16,-2,1549,0.59,"Samardzija, Jeff",1463,-2,24,1485,0.41
39,01_33_STL_WSH_19,"Wainwright, Adam",1535,-11,0,1524,0.49,"Sanchez, Anibal",1529,-21,24,1532,0.51
40,01_33_DET_PHI_19,"Ross, Tyson",1444,-1,-1,1442,0.35,"Velasquez, Vince",1521,-1,26,1546,0.65
41,01_33_LAD_SF_21,"Buehler, Walker",1567,19,0,1586,0.65,"Pomeranz, Drew",1463,-6,24,1481,0.35
42,01_33_CLE_MIA_19,"Bauer, Trevor",1547,22,-1,1568,0.67,"Alcantara, Sandy",1428,-8,23,1443,0.33
43,01_33_OAK_BOS_19,"Brooks, Aaron",1513,-2,0,1511,0.46,"Porcello, Rick",1537,-23,24,1538,0.54
44,01_33_SD_ATL_19,"Paddack, Chris",1486,20,0,1506,0.45,"Teheran, Julio",1513,6,24,1543,0.55
45,01_33_CIN_NYM_19,"Castillo, Luis",1497,29,0,1526,0.52,"Vargas, Jason",1518,-25,24,1517,0.48
46,01_33_HOU_MIN_19,"Cole, Gerrit",1579,14,0,1593,0.58,"Pineda, Michael",1519,-7,24,1536,0.42
47,01_33_COL_MIL_19,"Marquez, German",1512,30,0,1542,0.47,"Chacin, Jhoulys",1528,10,24,1562,0.53
48,01_33_BAL_CHW_20,"Cashner, Andrew",1417,-2,0,1415,0.41,"Nova, Ivan",1456,-7,24,1473,0.59
49,01_33_PIT_TEX_20,"Lyles, Jordan",1493,-29,-1,1463,0.47,"Sampson, Adrian",1473,-9,22,1486,0.53
50,01_33_NYY_ARI_21,"Sabathia, CC",1568,-8,-1,1559,0.5,"Greinke, Zack",1510,26,26,1562,0.5
51,01_33_TB_KC_20,"Snell, Blake",1537,41,0,1578,0.64,"Junis, Jakob",1448,6,24,1478,0.36
52,01_36_STL_CHC_14,"Flaherty, Jack",1539,11,-3,1547,0.49,"Hendricks, Kyle",1531,1,22,1554,0.51
53,01_33_CHC_SEA_22,"Hamels, Cole",1527,13,-1,1539,0.54,"Hernandez, Felix",1497,-11,26,1512,0.46
54,01_33_TOR_LAA_22,"Buchholz, Clay",1488,14,-2,1500,0.48,"Canning, Griffin",1500,-6,23,1517,0.52
55,01_35_SD_ATL_12,"Strahm, Matt",1485,12,0,1497,0.42,"Foltynewicz, Mike",1515,18,24,1557,0.58
56,01_35_CIN_NYM_12,"Mahle, Tyler",1498,-26,0,1472,0.4,"Syndergaard, Noah",1516,4,24,1544,0.6
57,01_35_HOU_MIN_13,"Peacock, Brad",1578,-14,0,1564,0.5,"Berrios, Jose",1520,20,24,1564,0.5
58,01_35_COL_MIL_13,"Gray, Jon",1512,-4,0,1508,0.44,"Peralta, Freddy",1528,0,24,1552,0.56
59,01_35_TB_KC_14,"Morton, Charlie",1534,15,0,1549,0.6,"Duffy, Danny",1451,3,24,1478,0.4
60,01_35_STL_WSH_16,"Hudson, Dakota",1540,-29,0,1511,0.43,"Strasburg, Stephen",1524,12,24,1560,0.57
61,01_35_BOS_CHW_20,"Price, David",1543,20,-3,1560,0.62,"Giolito, Lucas",1456,-4,24,1476,0.38
62,01_35_TOR_LAA_22,"Sanchez, Aaron",1487,-1,0,1486,0.44,"Skaggs, Tyler",1501,5,24,1530,0.56
63,01_36_TB_BAL_19,"Glasnow, Tyler",1535,-11,-3,1521,0.6,"Straily, Dan",1416,8,23,1447,0.4
64,01_36_MIN_NYY_19,"Gibson, Kyle",1522,6,-3,1525,0.39,"Paxton, James",1565,14,22,1601,0.61
65,01_36_WSH_PHI_19,"Hellickson, Jeremy",1525,-31,-2,1492,0.43,"Eickhoff, Jerad",1520,-3,26,1543,0.57
66,01_36_OAK_PIT_19,"Anderson, Brett",1508,-1,0,1507,0.48,"Musgrove, Joe",1495,4,23,1522,0.52
67,01_36_SF_CIN_19,"Beede, Tyler",1464,-20,-2,1442,0.38,"Gray, Sonny",1497,6,21,1524,0.62
68,01_36_SEA_CLE_19,"Kikuchi, Yusei",1492,-1,-2,1489,0.41,"Bieber, Shane",1546,-16,23,1553,0.59
69,01_36_KC_DET_19,"Lopez, Jorge",1450,-15,-3,1432,0.42,"Boyd, Matthew",1445,19,24,1488,0.58
70,01_36_ATL_MIA_19,"Gausman, Kevin",1511,7,-3,1515,0.59,"Urena, Jose",1428,-1,26,1453,0.41
71,01_36_TOR_TEX_20,"Thornton, Trent",1484,-8,-3,1473,0.41,"Minor, Mike",1471,39,26,1536,0.59
72,01_36_BOS_CHW_20,"Sale, Chris",1541,28,0,1569,0.6,"Lopez, Reynaldo",1458,13,24,1495,0.4
73,01_36_NYM_MIL_20,"Matz, Steven",1517,-15,-3,1499,0.43,"Woodruff, Brandon",1525,0,24,1549,0.57
74,01_36_ARI_COL_20,"Ray, Robbie",1512,12,-1,1523,0.5,"Anderson, Tyler",1515,-14,21,1522,0.5
75,01_36_LAD_SD_22,"Kershaw, Clayton",1566,15,0,1581,0.62,"Lauer, Eric",1489,-9,20,1500,0.38
76,01_37_MIN_NYY_13,"Odorizzi, Jake",1521,9,0,1530,0.42,"Happ, J.A.",1567,-5,24,1586,0.58
77,01_37_STL_CHC_16,"Wacha, Michael",1537,-4,0,1533,0.48,"Darvish, Yu",1533,-13,24,1544,0.52
78,01_37_SEA_CLE_16,"Leake, Mike",1492,-6,0,1486,0.38,"Carrasco, Carlos",1547,2,24,1573,0.62
79,01_37_KC_DET_16,"Bailey, Homer",1450,-21,0,1429,0.45,"Ross, Tyson",1446,-3,24,1467,0.55
80,01_37_ATL_MIA_18,"Soroka, Mike",1513,6,0,1519,0.6,"Richards, Trevor",1427,-1,24,1450,0.4
81,01_37_TB_BAL_19,"Stanek, Ryne",1537,-20,0,1517,0.61,"Bundy, Dylan",1414,0,24,1438,0.39
82,01_37_WSH_PHI_19,"Corbin, Patrick",1523,13,0,1536,0.49,"Arrieta, Jake",1521,-1,24,1544,0.51
83,01_37_OAK_PIT_19,"Bassitt, Chris",1512,11,0,1523,0.49,"Williams, Trevor",1491,17,24,1532,0.51
84,01_37_HOU_LAA_19,"Miley, Wade",1576,-14,-2,1560,0.58,"Cahill, Trevor",1504,-3,2,1503,0.42
85,01_37_BOS_CHW_19,"Rodriguez, Eduardo",1543,-6,0,1537,0.57,"Banuelos, Manny",1456,6,24,1486,0.43
86,01_37_SF_CIN_19,"Rodriguez, Dereck",1465,8,0,1473,0.45,"Roark, Tanner",1496,-10,24,1510,0.55
87,01_37_NYM_MIL_19,"Wheeler, Zack",1516,8,0,1524,0.46,"Gonzalez, Gio",1527,-2,24,1549,0.54
88,01_37_TOR_TEX_20,"Pannone, Thomas",1485,-16,0,1469,0.46,"Lynn, Lance",1470,4,24,1498,0.54
89,01_37_ARI_COL_20,"Weaver, Luke",1513,-8,0,1505,0.43,"Freeland, Kyle",1514,19,24,1557,0.57
90,01_37_LAD_SD_20,"Hill, Rich",1567,7,0,1574,0.6,"Lucchesi, Joey",1488,-10,24,1502,0.4
91,01_38_KC_DET_13,"Keller, Brad",1454,16,0,1470,0.48,"Turnbull, Spencer",1441,17,24,1482,0.52
92,01_38_TB_BAL_13,"Stanek, Ryne",1535,-20,0,1515,0.6,"Means, John",1417,7,24,1448,0.4
93,01_38_SEA_CLE_13,"Swanson, Erik",1491,-16,0,1475,0.43,"Anderson, Cody",1548,-45,24,1527,0.57
94,01_38_ATL_MIA_13,"Teheran, Julio",1515,4,0,1519,0.59,"Lopez, Pablo",1425,4,24,1453,0.41
95,01_38_OAK_PIT_13,"Montas, Frankie",1511,4,0,1515,0.53,"Lyles, Jordan",1492,-25,24,1491,0.47
96,01_38_WSH_PHI_14,"Sanchez, Anibal",1525,-20,0,1505,0.46,"Eflin, Zach",1520,-11,24,1533,0.54
97,01_38_BOS_CHW_14,"Porcello, Rick",1546,-17,0,1529,0.59,"Covey, Dylan",1453,-10,24,1467,0.41
98,01_38_NYM_MIL_14,"Vargas, Jason",1515,-26,0,1489,0.4,"Davies, Zach",1528,11,24,1563,0.6
99,01_38_TOR_TEX_15,"Buchholz, Clay",1484,14,0,1498,0.5,"Smyly, Drew",1471,4,24,1499,0.5
100,01_38_ARI_COL_15,"Greinke, Zack",1516,28,0,1544,0.47,"Marquez, German",1511,33,24,1568,0.53
101,01_38_HOU_LAA_16,"Verlander, Justin",1579,35,0,1614,0.66,"Harvey, Matt",1501,-5,0,1496,0.34
102,01_38_MIN_NYY_16,"Pineda, Michael",1523,-14,0,1509,0.41,"German, Domingo",1564,-14,24,1574,0.59
103,01_38_SF_CIN_16,"Samardzija, Jeff",1463,4,0,1467,0.38,"Castillo, Luis",1498,28,24,1550,0.62
104,01_38_LAD_SD_16,"Maeda, Kenta",1568,-16,0,1552,0.56,"Margevicius, Nick",1487,-2,24,1509,0.44
105,01_38_STL_CHC_19,"Wainwright, Adam",1536,-11,0,1525,0.45,"Quintana, Jose",1534,1,24,1559,0.55
106,01_39_SF_CIN_12,"Pomeranz, Drew",1464,-4,0,1460,0.42,"DeSclafani, Anthony",1497,-1,24,1520,0.58
107,01_39_CHW_CLE_18,"Nova, Ivan",1451,-7,-2,1442,0.3,"Bauer, Trevor",1544,22,24,1590,0.7
108,01_39_SEA_NYY_18,"Hernandez, Felix",1495,-13,-2,1480,0.36,"Sabathia, CC",1566,-8,24,1582,0.64
109,01_39_BOS_BAL_19,"Smith, Josh",1548,-33,-3,1512,0.59,"Means, John",1417,7,26,1450,0.41
110,01_39_MIN_TOR_19,"Perez, Martin",1522,-20,-2,1500,0.48,"Stroman, Marcus",1481,12,21,1514,0.52
111,01_39_ARI_TB_19,"Kelly, Merrill",1515,-12,-4,1499,0.37,"Snell, Blake",1535,31,23,1589,0.63
112,01_39_WSH_MIL_19,"Scherzer, Max",1523,30,-3,1550,0.48,"Chacin, Jhoulys",1528,13,24,1565,0.52
113,01_39_PHI_STL_20,"Velasquez, Vince",1522,-5,-3,1514,0.42,"Mikolas, Miles",1534,14,22,1570,0.58
114,01_39_MIA_CHC_20,"Alcantara, Sandy",1424,-18,-3,1403,0.28,"Hamels, Cole",1537,9,24,1570,0.72
115,01_39_KC_HOU_20,"Junis, Jakob",1452,5,-3,1454,0.28,"Cole, Gerrit",1580,20,21,1621,0.72
116,01_39_NYM_SD_22,"deGrom, Jacob",1514,44,-4,1554,0.53,"Paddack, Chris",1489,23,24,1536,0.47
117,01_39_ATL_LAD_22,"Fried, Max",1516,18,-4,1530,0.39,"Buehler, Walker",1566,18,23,1607,0.61
118,01_40_CHW_CLE_18,"Giolito, Lucas",1456,-2,0,1454,0.41,"Rodriguez, Jefry",1539,-43,24,1520,0.59
119,01_40_SEA_NYY_18,"Gonzales, Marco",1494,13,0,1507,0.37,"Tanaka, Masahiro",1567,4,24,1595,0.63
120,01_40_BOS_BAL_19,"Velazquez, Hector",1546,-27,0,1519,0.61,"Hess, David",1419,-3,24,1440,0.39
121,01_40_TEX_PIT_19,"Sampson, Adrian",1474,-2,-1,1471,0.47,"Brault, Steven",1494,-27,26,1493,0.53
122,01_40_MIN_TOR_19,"Berrios, Jose",1525,20,0,1545,0.56,"Sanchez, Aaron",1478,-3,24,1499,0.44
123,01_40_LAA_DET_19,"Canning, Griffin",1499,-4,-2,1493,0.54,"Norris, Daniel",1443,-1,26,1468,0.46
124,01_40_ARI_TB_19,"Clarke, Taylor",1513,-17,0,1496,0.44,"Stanek, Ryne",1537,-21,24,1540,0.56
125,01_40_WSH_MIL_19,"Strasburg, Stephen",1521,14,0,1535,0.5,"Houser, Adrian",1530,-19,24,1535,0.5
126,01_40_PHI_STL_19,"Nola, Aaron",1520,27,0,1547,0.51,"Hudson, Dakota",1536,-22,24,1538,0.49
127,01_40_MIA_CHC_20,"Smith, Caleb",1425,18,0,1443,0.33,"Lester, Jon",1535,7,24,1566,0.67
128,01_40_KC_HOU_20,"Duffy, Danny",1452,6,0,1458,0.31,"McHugh, Collin",1581,-9,24,1596,0.69
129,01_40_SF_COL_20,"Bumgarner, Madison",1462,23,-3,1482,0.43,"Senzatela, Antonio",1512,-11,26,1527,0.57
130,01_40_CIN_OAK_22,"Mahle, Tyler",1499,-24,-4,1471,0.41,"Fiers, Mike",1509,3,22,1534,0.59
131,01_40_ATL_LAD_22,"Fried, Max",1515,18,0,1533,0.41,"Ryu, Hyun-Jin",1567,3,24,1594,0.59
132,01_40_NYM_SD_22,"Syndergaard, Noah",1512,9,0,1521,0.52,"Quantrill, Cal",1491,-6,24,1509,0.48
133,01_41_TEX_PIT_12,"Miller, Shelby",1473,-24,0,1449,0.46,"Kingham, Nick",1495,-41,24,1478,0.54
134,01_41_WSH_MIL_13,"Hellickson, Jeremy",1519,-29,0,1490,0.41,"Woodruff, Brandon",1532,-1,24,1555,0.59
135,01_41_ARI_TB_13,"Ray, Robbie",1511,11,0,1522,0.42,"Morton, Charlie",1539,15,24,1578,0.58
136,01_41_PHI_STL_13,"Eickhoff, Jerad",1523,-1,0,1522,0.43,"Flaherty, Jack",1533,13,24,1570,0.57
137,01_41_NYM_SD_15,"Font, Wilmer",1513,-6,0,1507,0.47,"Strahm, Matt",1490,13,24,1527,0.53
138,01_41_CHW_CLE_18,"Lopez, Reynaldo",1457,9,0,1466,0.38,"Bieber, Shane",1538,-9,24,1553,0.62
139,01_41_SEA_NYY_18,"Kikuchi, Yusei",1493,9,0,1502,0.39,"Loaisiga, Jonathan",1568,-15,24,1577,0.61
140,01_41_BOS_BAL_19,"Sale, Chris",1547,32,0,1579,0.7,"Cashner, Andrew",1417,-5,24,1436,0.3
141,01_41_MIN_TOR_19,"Gibson, Kyle",1526,0,0,1526,0.53,"Thornton, Trent",1477,8,24,1509,0.47
142,01_41_LAA_DET_19,"Skaggs, Tyler",1501,8,0,1509,0.53,"Boyd, Matthew",1442,23,24,1489,0.47
143,01_41_MIA_CHC_20,"Urena, Jose",1424,-6,0,1418,0.3,"Hendricks, Kyle",1536,8,24,1568,0.7
144,01_41_KC_HOU_20,"Lopez, Jorge",1457,-11,0,1446,0.31,"Peacock, Brad",1576,-17,24,1583,0.69
145,01_41_SF_COL_20,"Holland, Derek",1465,-2,0,1463,0.41,"Gray, Jon",1508,-1,24,1531,0.59
146,01_41_CIN_OAK_22,"Gray, Sonny",1498,3,0,1501,0.45,"Anderson, Brett",1510,-1,24,1533,0.55
147,01_41_ATL_LAD_22,"Foltynewicz, Mike",1512,14,0,1526,0.39,"Kershaw, Clayton",1569,12,24,1605,0.61
148,01_42_CHW_CLE_13,"Banuelos, Manny",1456,-11,0,1445,0.33,"Carrasco, Carlos",1538,4,24,1566,0.67
149,01_42_LAA_DET_13,Pitcher TBD,1498,1,0,1499,0.58,"Carpenter, Ryan",1444,-25,24,1443,0.42
150,01_42_MIA_CHC_14,"Richards, Trevor",1424,-1,0,1423,0.33,"Darvish, Yu",1537,-18,24,1543,0.67
151,01_42_SF_COL_15,"Holland, Derek",1465,-2,2,1465,0.38,"Freeland, Kyle",1508,14,26,1548,0.62
152,01_42_CIN_OAK_15,"Roark, Tanner",1498,-8,0,1490,0.43,"Bassitt, Chris",1510,7,24,1541,0.57
153,01_42_SEA_NYY_18,"Leake, Mike",1497,-8,0,1489,0.37,"Happ, J.A.",1564,-7,24,1581,0.63
154,01_42_PIT_STL_19,"Musgrove, Joe",1493,-1,-3,1489,0.42,"Wacha, Michael",1530,-6,24,1548,0.58
155,01_42_TEX_HOU_20,"Minor, Mike",1475,43,-3,1515,0.4,"Miley, Wade",1577,-13,24,1588,0.6
156,01_42_ATL_ARI_21,"Soroka, Mike",1512,11,-2,1521,0.49,"Weaver, Luke",1513,-2,20,1531,0.51
157,01_42_WSH_LAD_22,"Corbin, Patrick",1517,12,-4,1525,0.4,"Hill, Rich",1569,1,24,1594,0.6
158,01_43_MIL_CHC_14,"Gonzalez, Gio",1534,0,1,1535,0.46,"Quintana, Jose",1538,0,24,1562,0.54
159,01_43_LAA_BAL_19,"Cahill, Trevor",1501,-8,-2,1491,0.57,"Straily, Dan",1417,1,26,1444,0.43
160,01_43_CHW_TOR_19,"Covey, Dylan",1455,-9,-2,1444,0.4,"Buchholz, Clay",1474,10,26,1510,0.6
161,01_43_SEA_BOS_19,"Swanson, Erik",1496,-9,-2,1485,0.38,"Rodriguez, Eduardo",1548,-5,24,1567,0.62
162,01_43_MIA_NYM_19,"Lopez, Pablo",1423,9,-3,1429,0.34,"Wheeler, Zack",1512,12,22,1546,0.66
163,01_43_NYY_TB_19,"German, Domingo",1564,-11,-3,1550,0.49,"Glasnow, Tyler",1537,-6,26,1557,0.51
164,01_43_TEX_HOU_20,"Lynn, Lance",1474,2,0,1476,0.29,"Verlander, Justin",1578,32,24,1634,0.71
165,01_43_DET_MIN_20,"Ross, Tyson",1441,-10,-3,1428,0.32,"Odorizzi, Jake",1529,10,23,1562,0.68
166,01_43_PHI_KC_20,"Arrieta, Jake",1526,-1,0,1525,0.59,"Bailey, Homer",1455,-18,23,1460,0.41
167,01_43_PIT_STL_20,"Williams, Trevor",1490,17,0,1507,0.44,"Wainwright, Adam",1533,-11,24,1546,0.56
168,01_43_SD_COL_20,"Lauer, Eric",1491,-9,-1,1481,0.38,"Marquez, German",1509,32,24,1565,0.62
169,01_43_CLE_OAK_21,"Anderson, Cody",1540,-47,-4,1489,0.43,"Montas, Frankie",1509,5,24,1538,0.57
170,01_43_ATL_ARI_21,"Teheran, Julio",1510,8,0,1518,0.43,"Greinke, Zack",1514,28,24,1566,0.57
171,01_43_WSH_LAD_22,"Sanchez, Anibal",1517,-17,0,1500,0.39,"Maeda, Kenta",1571,-17,24,1578,0.61
172,01_43_CIN_SF_22,"Castillo, Luis",1499,27,-1,1525,0.55,"Rodriguez, Dereck",1465,4,21,1490,0.45
173,01_44_SEA_BOS_13,"Hernandez, Felix",1493,-19,0,1474,0.38,"Porcello, Rick",1550,-17,24,1557,0.62
174,01_44_DET_MIN_14,"Turnbull, Spencer",1440,23,0,1463,0.4,"Pineda, Michael",1530,-19,24,1535,0.6
175,01_44_PIT_STL_14,"Lyles, Jordan",1491,-21,0,1470,0.35,"Mikolas, Miles",1532,19,24,1575,0.65
176,01_44_MIL_CHC_14,"Davies, Zach",1537,10,0,1547,0.47,"Hamels, Cole",1535,7,24,1566,0.53
177,01_44_CHW_TOR_15,"Nova, Ivan",1454,-3,0,1451,0.42,"Stroman, Marcus",1475,9,24,1508,0.58
178,01_44_LAA_BAL_16,"Harvey, Matt",1503,-6,0,1497,0.58,"Bundy, Dylan",1415,5,24,1444,0.42
179,01_44_CLE_OAK_16,"Bauer, Trevor",1540,14,0,1554,0.54,"Brooks, Aaron",1509,-10,24,1523,0.46
180,01_44_NYY_TB_18,"Sabathia, CC",1566,-9,0,1557,0.52,"Stanek, Ryne",1536,-19,24,1541,0.48
181,01_44_MIA_NYM_19,"Alcantara, Sandy",1421,-17,0,1404,0.26,"deGrom, Jacob",1514,44,24,1582,0.74
182,01_44_PHI_KC_19,"Eflin, Zach",1524,-7,0,1517,0.53,"Keller, Brad",1457,17,24,1498,0.47
183,01_44_ATL_ARI_20,"Gausman, Kevin",1511,2,0,1513,0.5,"Kelly, Merrill",1512,-24,24,1512,0.5
184,01_44_SD_COL_20,"Lucchesi, Joey",1489,-9,0,1480,0.42,"Gray, Jon",1511,-1,24,1534,0.58
185,01_44_TEX_HOU_20,"Chavez, Jesse",1473,-17,0,1456,0.28,"Cole, Gerrit",1579,17,24,1620,0.72
186,01_44_DET_MIN_20,"Soto, Gregory",1440,-4,0,1436,0.38,"Stewart, Kohl",1530,-35,24,1519,0.62
187,01_44_CIN_SF_21,"DeSclafani, Anthony",1499,-2,0,1497,0.5,"Samardzija, Jeff",1465,6,24,1495,0.5
188,01_44_WSH_LAD_21,"Scherzer, Max",1520,31,0,1551,0.42,"Buehler, Walker",1568,18,24,1610,0.58
189,01_45_LAA_BAL_13,"Canning, Griffin",1505,1,0,1506,0.57,"Means, John",1413,17,24,1454,0.43
190,01_45_SEA_BOS_13,"Gonzales, Marco",1492,16,0,1508,0.45,"Velazquez, Hector",1552,-31,24,1545,0.55
191,01_45_CHW_TOR_13,"Giolito, Lucas",1457,5,0,1462,0.45,"Sanchez, Aaron",1472,1,24,1497,0.55
192,01_45_MIA_NYM_13,"Smith, Caleb",1420,24,0,1444,0.36,"Syndergaard, Noah",1515,4,24,1543,0.64
193,01_45_NYY_TB_13,"Tanaka, Masahiro",1563,6,0,1569,0.46,"Snell, Blake",1539,34,24,1597,0.54
194,01_45_TEX_HOU_14,"Sampson, Adrian",1472,-7,0,1465,0.36,"Martin, Corbin",1580,-37,24,1567,0.64
195,01_45_DET_MIN_14,"Norris, Daniel",1440,1,0,1441,0.36,"Perez, Martin",1530,-16,24,1538,0.64
196,01_45_PHI_KC_14,"Irvin, Cole",1526,-19,0,1507,0.54,"Junis, Jakob",1455,2,24,1481,0.46
197,01_45_PIT_STL_14,"Brault, Steven",1493,-25,0,1468,0.42,"Hudson, Dakota",1530,-31,24,1523,0.58
198,01_45_SD_COL_15,"Margevicius, Nick",1490,-6,0,1484,0.45,"Senzatela, Antonio",1510,-15,24,1519,0.55
199,01_45_CIN_SF_16,"Mahle, Tyler",1503,-18,0,1485,0.46,"Bumgarner, Madison",1461,26,24,1511,0.54
200,01_45_CLE_OAK_16,"Rodriguez, Jefry",1538,-41,0,1497,0.45,"Mengden, Daniel",1511,-2,24,1533,0.55
201,01_45_ATL_ARI_16,"Fried, Max",1512,10,0,1522,0.52,"Godley, Zack",1511,-23,24,1512,0.48
202,01_45_WSH_LAD_16,"Strasburg, Stephen",1521,15,0,1536,0.41,"Ryu, Hyun-Jin",1567,8,24,1599,0.59
203,01_45_MIL_CHC_19,"Chacin, Jhoulys",1536,10,0,1546,0.47,"Lester, Jon",1536,5,24,1565,0.53
204,01_46_BAL_NYY_18,"Hess, David",1416,-5,-2,1409,0.29,"Loaisiga, Jonathan",1566,-19,21,1568,0.71
205,01_46_MIL_PHI_19,"Peralta, Freddy",1534,-14,-3,1517,0.42,"Nola, Aaron",1528,26,21,1575,0.58
206,01_46_HOU_DET_19,"Peacock, Brad",1582,-13,-3,1566,0.61,"Boyd, Matthew",1442,27,21,1490,0.39
207,01_46_LAA_MIN_19,"Skaggs, Tyler",1503,4,-3,1504,0.4,"Berrios, Jose",1529,22,24,1575,0.6
208,01_46_CLE_CHW_20,"Bieber, Shane",1539,-10,-4,1525,0.55,"Lopez, Reynaldo",1459,9,22,1490,0.45
209,01_46_PIT_ARI_21,"Kingham, Nick",1495,-37,-3,1455,0.37,"Ray, Robbie",1510,12,24,1546,0.63
210,01_46_OAK_SEA_22,"Fiers, Mike",1510,11,-3,1518,0.48,"Kikuchi, Yusei",1489,20,20,1529,0.52
211,01_47_CLE_CHW_14,"Carrasco, Carlos",1537,8,0,1545,0.61,"Banuelos, Manny",1461,-21,24,1464,0.39
212,01_47_BAL_NYY_18,"Cashner, Andrew",1416,-2,0,1414,0.27,"Happ, J.A.",1566,-3,23,1586,0.73
213,01_47_CHC_CIN_18,"Hendricks, Kyle",1537,11,0,1548,0.54,"Roark, Tanner",1502,-3,22,1521,0.46
214,01_47_MIL_PHI_19,"Woodruff, Brandon",1533,2,0,1535,0.47,"Eickhoff, Jerad",1529,3,24,1556,0.53
215,01_47_NYM_WSH_19,"Syndergaard, Noah",1515,4,3,1522,0.52,"Hellickson, Jeremy",1519,-34,22,1507,0.48
216,01_47_COL_BOS_19,"Freeland, Kyle",1511,10,-2,1519,0.36,"Sale, Chris",1554,36,26,1616,0.64
217,01_47_HOU_DET_19,"Miley, Wade",1584,-13,0,1571,0.69,"Carpenter, Ryan",1440,-28,24,1436,0.31
218,01_47_TB_MIA_19,"Morton, Charlie",1536,13,0,1549,0.61,"Smith, Caleb",1420,24,26,1470,0.39
219,01_47_STL_ATL_19,"Flaherty, Jack",1528,10,0,1538,0.49,"Foltynewicz, Mike",1514,9,22,1545,0.51
220,01_47_LAA_MIN_19,"Bedrosian, Cam",1504,-2,0,1502,0.42,"Gibson, Kyle",1527,5,24,1556,0.58
221,01_47_TEX_KC_20,"Miller, Shelby",1470,-22,-1,1447,0.44,"Duffy, Danny",1453,10,26,1489,0.56
222,01_47_PIT_ARI_21,"Musgrove, Joe",1495,-7,0,1488,0.43,"Weaver, Luke",1510,1,24,1535,0.57
223,01_47_TOR_SF_21,"Thornton, Trent",1470,-3,-2,1465,0.5,"Beede, Tyler",1462,-25,26,1463,0.5
224,01_47_SD_LAD_22,"Paddack, Chris",1489,32,-1,1520,0.38,"Kershaw, Clayton",1569,7,26,1602,0.62
225,01_47_OAK_SEA_22,"Anderson, Brett",1510,-2,0,1508,0.49,"Leake, Mike",1489,-2,24,1511,0.51
226,01_48_LAA_MIN_13,"Cahill, Trevor",1503,-4,0,1499,0.4,"Odorizzi, Jake",1528,17,24,1569,0.6
227,01_48_BAL_NYY_15,Pitcher TBD,1416,1,3,1420,0.28,"German, Domingo",1566,-12,26,1580,0.72
228,01_48_PIT_ARI_15,"Archer, Chris",1496,-1,0,1495,0.4,"Greinke, Zack",1509,31,24,1564,0.6
229,01_48_TOR_SF_15,Pitcher TBD,1472,0,0,1472,0.48,Pitcher TBD,1460,1,24,1485,0.52
230,01_48_BAL_NYY_18,"Straily, Dan",1416,-1,0,1415,0.27,Pitcher TBD,1566,0,24,1590,0.73
231,01_48_CHC_CIN_18,"Darvish, Yu",1538,-19,0,1519,0.49,"Gray, Sonny",1501,-1,24,1524,0.51
232,01_48_MIL_PHI_19,"Gonzalez, Gio",1535,1,0,1536,0.49,"Arrieta, Jake",1527,-5,24,1546,0.51
233,01_48_NYM_WSH_19,"Font, Wilmer",1516,-9,0,1507,0.43,"Corbin, Patrick",1517,16,24,1557,0.57
234,01_48_COL_BOS_19,"Marquez, German",1513,32,0,1545,0.46,"Rodriguez, Eduardo",1553,-2,24,1575,0.54
235,01_48_HOU_DET_19,"Verlander, Justin",1586,35,0,1621,0.71,Pitcher TBD,1438,2,24,1464,0.29
236,01_48_TB_MIA_19,Pitcher TBD,1537,1,0,1538,0.63,"Urena, Jose",1419,0,24,1443,0.37
237,01_48_STL_ATL_19,"Wacha, Michael",1532,-9,0,1523,0.46,"Soroka, Mike",1510,15,24,1549,0.54
238,01_48_TEX_KC_20,"Minor, Mike",1468,43,0,1511,0.57,"Lopez, Jorge",1455,-19,24,1460,0.43
239,01_48_SD_LAD_22,"Strahm, Matt",1488,15,0,1503,0.39,"Maeda, Kenta",1570,-15,24,1579,0.61
240,01_49_MIL_PHI_13,"Davies, Zach",1537,12,0,1549,0.5,"Eflin, Zach",1525,1,24,1550,0.5
241,01_49_NYM_WSH_13,"Wheeler, Zack",1515,12,0,1527,0.51,"Sanchez, Anibal",1519,-22,24,1521,0.49
242,01_49_OAK_DET_13,"Bassitt, Chris",1508,9,-2,1515,0.54,"Turnbull, Spencer",1438,27,24,1489,0.46
243,01_49_TEX_KC_13,"Lynn, Lance",1469,6,0,1475,0.52,"Bailey, Homer",1453,-14,24,1463,0.48
244,01_49_BAL_CLE_18,"Straily, Dan",1414,-2,-2,1410,0.27,"Bauer, Trevor",1540,18,24,1582,0.73
245,01_49_CHC_CIN_18,"Quintana, Jose",1537,-2,0,1535,0.47,"Castillo, Luis",1502,29,24,1555,0.53
246,01_49_STL_ATL_19,"Wainwright, Adam",1530,-8,0,1522,0.46,"Teheran, Julio",1512,11,24,1547,0.54
247,01_49_TOR_CHW_20,"Stroman, Marcus",1471,9,-4,1476,0.51,"Covey, Dylan",1459,-13,26,1472,0.49
248,01_49_MIN_SEA_22,"Pineda, Michael",1529,-17,-3,1509,0.51,"Swanson, Erik",1491,-13,26,1504,0.49
249,01_49_PIT_SD_22,"Williams, Trevor",1493,20,-2,1511,0.52,"Lauer, Eric",1488,-14,23,1497,0.48
250,01_50_TB_NYY_19,"Stanek, Ryne",1538,-20,-1,1517,0.41,"Sabathia, CC",1567,-12,26,1581,0.59
251,01_50_COL_PHI_19,"Gray, Jon",1512,-1,0,1511,0.46,"Irvin, Cole",1522,-9,24,1537,0.54
252,01_50_CHC_WSH_19,"Hamels, Cole",1536,8,-2,1542,0.45,"Scherzer, Max",1520,31,24,1575,0.55
253,01_50_HOU_BOS_19,"Cole, Gerrit",1587,19,-1,1605,0.56,"Porcello, Rick",1554,-16,26,1564,0.44
254,01_50_LAD_CIN_19,"Hill, Rich",1571,-5,-2,1564,0.56,"DeSclafani, Anthony",1503,-7,24,1520,0.44
255,01_50_BAL_CLE_19,"Bundy, Dylan",1413,4,0,1417,0.35,"Rodriguez, Jefry",1541,-39,24,1526,0.65
256,01_50_OAK_DET_19,"Montas, Frankie",1511,5,0,1516,0.58,"Norris, Daniel",1434,5,24,1463,0.42
257,01_50_NYM_MIA_19,"deGrom, Jacob",1514,46,-3,1557,0.66,"Richards, Trevor",1418,-1,26,1443,0.34
258,01_50_MIL_ATL_19,"Chacin, Jhoulys",1540,10,-3,1547,0.5,"Fried, Max",1514,8,24,1546,0.5
259,01_50_STL_TEX_20,"Mikolas, Miles",1527,23,-3,1547,0.58,"Leclerc, Jose",1474,-5,22,1491,0.42
260,01_50_TOR_CHW_20,"Sanchez, Aaron",1470,-1,0,1469,0.48,"Nova, Ivan",1460,-4,24,1480,0.52
261,01_50_SF_ARI_21,"Samardzija, Jeff",1461,5,-1,1465,0.43,"Kelly, Merrill",1512,-22,26,1516,0.57
262,01_50_KC_LAA_22,"Keller, Brad",1449,15,-3,1461,0.42,"Harvey, Matt",1502,-4,22,1520,0.58
263,01_50_PIT_SD_22,"Lyles, Jordan",1493,-13,0,1480,0.46,"Lucchesi, Joey",1487,-3,24,1508,0.54
264,01_50_MIN_SEA_22,"Perez, Martin",1529,-15,0,1514,0.48,"Gonzales, Marco",1491,14,24,1529,0.52
265,01_51_TB_NYY_13,"Snell, Blake",1537,35,0,1572,0.46,"Tanaka, Masahiro",1568,8,24,1600,0.54
266,01_51_TOR_CHW_14,"Hudson, Daniel",1473,-9,0,1464,0.46,"Giolito, Lucas",1457,12,24,1493,0.54
267,01_51_STL_TEX_16,"Hudson, Dakota",1525,-28,0,1497,0.51,"Jurado, Ariel",1476,-12,24,1488,0.49
268,01_51_COL_PHI_16,"Senzatela, Antonio",1511,-10,0,1501,0.4,"Nola, Aaron",1523,24,24,1571,0.6
269,01_51_LAD_CIN_16,"Buehler, Walker",1573,16,0,1589,0.62,"Mahle, Tyler",1501,-19,24,1506,0.38
270,01_51_BAL_CLE_16,"Means, John",1416,19,0,1435,0.38,"Plutko, Adam",1538,-44,24,1518,0.62
271,01_51_OAK_DET_16,"Mengden, Daniel",1513,-5,0,1508,0.54,"Boyd, Matthew",1432,27,24,1483,0.46
272,01_51_NYM_MIA_16,"Matz, Steven",1512,-14,0,1498,0.58,"Lopez, Pablo",1420,-3,24,1441,0.42
273,01_51_MIL_ATL_19,"Anderson, Chase",1538,8,0,1546,0.5,"Gausman, Kevin",1516,4,24,1544,0.5
274,01_51_HOU_BOS_19,"Martin, Corbin",1588,-32,0,1556,0.51,"Velazquez, Hector",1553,-30,24,1547,0.49
275,01_51_CHC_WSH_19,"Lester, Jon",1539,6,0,1545,0.48,"Strasburg, Stephen",1516,16,24,1556,0.52
276,01_51_PIT_SD_20,"Brault, Steven",1492,-29,0,1463,0.44,"Margevicius, Nick",1488,-9,24,1503,0.56
277,01_51_KC_LAA_22,"Junis, Jakob",1449,2,0,1451,0.4,"Canning, Griffin",1502,-4,24,1522,0.6
278,01_51_SF_ARI_22,"Bumgarner, Madison",1459,25,0,1484,0.46,"Godley, Zack",1514,-24,24,1514,0.54
279,01_51_MIN_SEA_22,"Berrios, Jose",1534,15,0,1549,0.55,"LeBlanc, Wade",1487,6,24,1517,0.45
280,01_52_HOU_BOS_13,"Miley, Wade",1589,-15,0,1574,0.44,"Sale, Chris",1551,40,24,1615,0.56
281,01_52_TB_NYY_13,"Morton, Charlie",1538,15,0,1553,0.5,"Green, Chad",1567,-36,24,1555,0.5
282,01_52_COL_PHI_13,"Freeland, Kyle",1510,10,0,1520,0.46,"Eickhoff, Jerad",1524,-2,24,1546,0.54
283,01_52_LAD_CIN_13,"Ryu, Hyun-Jin",1571,11,0,1582,0.58,"Roark, Tanner",1503,-4,24,1523,0.42
284,01_52_BAL_CLE_13,"Ramirez, Yefry",1415,-9,0,1406,0.3,"Bieber, Shane",1539,-13,24,1550,0.7
285,01_52_OAK_DET_13,"Fiers, Mike",1515,8,0,1523,0.61,"Soto, Gregory",1431,-11,24,1444,0.39
286,01_52_NYM_MIA_13,"Syndergaard, Noah",1510,11,0,1521,0.64,"Alcantara, Sandy",1422,-22,24,1424,0.36
287,01_52_MIL_ATL_13,"Woodruff, Brandon",1537,5,0,1542,0.5,"Foltynewicz, Mike",1517,-1,24,1540,0.5
288,01_52_TOR_CHW_14,"Thornton, Trent",1471,-2,0,1469,0.46,"Lopez, Reynaldo",1458,15,24,1497,0.54
289,01_52_STL_TEX_15,"Flaherty, Jack",1527,13,0,1540,0.55,"Smyly, Drew",1474,7,24,1505,0.45
290,01_52_SF_ARI_16,"Pomeranz, Drew",1459,-8,0,1451,0.36,"Ray, Robbie",1514,11,24,1549,0.64
291,01_52_KC_LAA_16,"Duffy, Danny",1447,11,0,1458,0.4,"Skaggs, Tyler",1505,1,24,1530,0.6
292,01_52_PIT_SD_16,"Musgrove, Joe",1496,0,0,1496,0.49,"Quantrill, Cal",1484,-5,24,1503,0.51
293,01_52_MIN_SEA_16,"Gibson, Kyle",1534,5,0,1539,0.51,"Kikuchi, Yusei",1487,19,24,1530,0.49
294,01_52_CHC_WSH_19,"Hendricks, Kyle",1538,16,0,1554,0.57,"Hellickson, Jeremy",1518,-38,24,1504,0.43
295,01_53_BOS_TOR_13,"Price, David",1552,14,-2,1564,0.62,"Jackson, Edwin",1473,-14,22,1481,0.38
296,01_53_OAK_CLE_18,"Anderson, Brett",1515,-8,1,1508,0.4,"Carrasco, Carlos",1541,10,24,1575,0.6
297,01_53_NYY_BAL_19,"Happ, J.A.",1570,-5,-2,1563,0.67,"Cashner, Andrew",1413,3,22,1438,0.33
298,01_53_WSH_NYM_19,"Corbin, Patrick",1517,21,-2,1536,0.56,"Gagnon, Drew",1508,-31,21,1498,0.44
299,01_53_PHI_CHC_20,"Arrieta, Jake",1525,-5,-3,1517,0.46,"Darvish, Yu",1539,-14,21,1546,0.54
300,01_53_SEA_TEX_20,"Leake, Mike",1485,5,-4,1486,0.43,"Minor, Mike",1475,39,24,1538,0.57
301,01_53_CHW_HOU_20,Pitcher TBD,1457,-1,-3,1453,0.3,"Peacock, Brad",1589,-12,20,1597,0.7
302,01_53_ATL_SF_21,"Soroka, Mike",1516,19,-4,1531,0.57,"Suarez, Andrew",1462,1,21,1484,0.43
303,01_53_MIN_LAA_22,"Odorizzi, Jake",1536,13,-3,1546,0.55,"Cole, Taylor",1502,-14,24,1512,0.45
304,01_53_ARI_SD_22,"Weaver, Luke",1511,0,-2,1509,0.47,"Paddack, Chris",1482,26,24,1532,0.53
305,01_54_OAK_CLE_18,"Bassitt, Chris",1516,10,0,1526,0.43,"Bauer, Trevor",1539,10,24,1573,0.57
306,01_54_PHI_CHC_19,"Eflin, Zach",1527,0,0,1527,0.45,"Quintana, Jose",1538,-1,24,1561,0.55
307,01_54_COL_PIT_19,"Marquez, German",1509,31,0,1540,0.54,"Archer, Chris",1497,-5,22,1514,0.46
308,01_54_NYY_BAL_19,"German, Domingo",1571,-7,0,1564,0.68,"Hess, David",1412,-6,24,1430,0.32
309,01_54_BOS_TOR_19,"Rodriguez, Eduardo",1554,-2,0,1552,0.57,"Stroman, Marcus",1471,10,24,1505,0.43
310,01_54_MIA_DET_19,"Smith, Caleb",1424,21,-1,1444,0.45,"Turnbull, Spencer",1431,21,29,1481,0.55
311,01_54_WSH_NYM_19,"Fedde, Erick",1516,-42,0,1474,0.4,"Wheeler, Zack",1509,10,24,1543,0.6
312,01_54_LAD_TB_19,"Kershaw, Clayton",1573,3,-1,1575,0.57,"Wood, Hunter",1536,-29,23,1530,0.43
313,01_54_CIN_MIL_19,"Gray, Sonny",1502,-3,0,1499,0.41,"Gonzalez, Gio",1538,0,23,1561,0.59
314,01_54_SEA_TEX_20,"Milone, Tommy",1484,-16,0,1468,0.44,"Lynn, Lance",1475,7,24,1506,0.56
315,01_54_CHW_HOU_20,"Covey, Dylan",1456,-10,0,1446,0.24,"Verlander, Justin",1589,36,24,1649,0.76
316,01_54_KC_STL_20,"Bailey, Homer",1449,-17,-2,1430,0.35,"Wacha, Michael",1526,-8,23,1541,0.65
317,01_54_ATL_SF_21,"Teheran, Julio",1518,10,0,1528,0.56,"Anderson, Shaun",1461,-1,24,1484,0.44
318,01_54_MIN_LAA_22,"Pineda, Michael",1536,-16,0,1520,0.5,"Cahill, Trevor",1502,-8,24,1518,0.5
319,01_54_ARI_SD_22,"Greinke, Zack",1510,35,0,1545,0.53,"Strahm, Matt",1483,16,24,1523,0.47
320,01_55_OAK_CLE_13,"Montas, Frankie",1518,10,0,1528,0.51,"Rodriguez, Jefry",1538,-41,24,1521,0.49
321,01_55_CIN_MIL_13,"Castillo, Luis",1504,29,0,1533,0.44,"Davies, Zach",1536,12,24,1572,0.56
322,01_55_KC_STL_13,"Keller, Brad",1449,13,1,1463,0.39,"Wacha, Michael",1526,-8,26,1544,0.61
323,01_55_SEA_TEX_14,"Gonzales, Marco",1483,13,0,1496,0.52,"Sampson, Adrian",1477,-19,24,1482,0.48
324,01_55_ARI_SD_15,"Kelly, Merrill",1509,-17,0,1492,0.49,"Lauer, Eric",1484,-12,24,1496,0.51
325,01_55_NYY_BAL_19,"Sabathia, CC",1572,-9,0,1563,0.68,"Straily, Dan",1411,-3,24,1432,0.32
326,01_55_COL_PIT_19,"Gray, Jon",1511,-4,0,1507,0.5,"DuRapau, Montana",1495,-15,24,1504,0.5
327,01_55_BOS_TOR_19,"Porcello, Rick",1551,-12,0,1539,0.56,"Sanchez, Aaron",1474,-1,24,1497,0.44
328,01_55_MIA_DET_19,"Urena, Jose",1425,-1,0,1424,0.45,"Norris, Daniel",1429,3,24,1456,0.55
329,01_55_WSH_NYM_19,"Scherzer, Max",1515,30,0,1545,0.46,"deGrom, Jacob",1510,39,24,1573,0.54
330,01_55_LAD_TB_19,"Hill, Rich",1574,0,0,1574,0.55,"Stanek, Ryne",1534,-19,24,1539,0.45
331,01_55_PHI_CHC_20,"Irvin, Cole",1526,-10,0,1516,0.42,"Hamels, Cole",1539,6,24,1569,0.58
332,01_55_CHW_HOU_20,"Nova, Ivan",1455,-14,0,1441,0.25,"Cole, Gerrit",1590,19,24,1633,0.75
333,01_55_MIN_LAA_21,"Perez, Martin",1537,-12,0,1525,0.51,"Harvey, Matt",1501,-5,24,1520,0.49
334,01_55_ATL_SF_21,"Fried, Max",1518,11,0,1529,0.56,"Samardzija, Jeff",1461,4,24,1489,0.44
335,01_56_WSH_NYM_12,"Strasburg, Stephen",1513,20,0,1533,0.52,"Matz, Steven",1512,-16,24,1520,0.48
336,01_56_NYY_BAL_12,"Tanaka, Masahiro",1573,15,0,1588,0.7,"Bundy, Dylan",1410,11,24,1445,0.3
337,01_56_COL_PIT_12,"Senzatela, Antonio",1513,-12,0,1501,0.49,"Lyles, Jordan",1493,-8,24,1509,0.51
338,01_56_BOS_TOR_12,"Weber, Ryan",1552,-42,0,1510,0.56,"Richard, Clayton",1473,-27,24,1470,0.44
339,01_56_MIA_DET_13,"Richards, Trevor",1427,-5,0,1422,0.42,"Boyd, Matthew",1428,27,24,1479,0.58
340,01_56_PHI_CHC_14,"Nola, Aaron",1524,27,0,1551,0.48,"Lester, Jon",1540,1,24,1565,0.52
341,01_56_ATL_SF_15,"Gausman, Kevin",1519,3,0,1522,0.52,"Bumgarner, Madison",1460,25,24,1509,0.48
342,01_56_TB_CLE_18,Pitcher TBD,1537,1,-3,1535,0.52,"Plutko, Adam",1536,-37,24,1523,0.48
343,01_56_CHW_HOU_20,"Giolito, Lucas",1459,13,0,1472,0.36,"Martin, Corbin",1586,-36,24,1574,0.64
344,01_57_CIN_CHC_14,"DeSclafani, Anthony",1503,-10,1,1494,0.38,"Hendricks, Kyle",1539,14,24,1577,0.62
345,01_57_LAD_PIT_19,"Buehler, Walker",1571,13,-1,1583,0.59,Pitcher TBD,1496,-1,24,1519,0.41
346,01_57_MIA_WSH_19,"Lopez, Pablo",1429,0,-2,1427,0.39,"McGowin, Kyle",1511,-29,22,1504,0.61
347,01_57_SD_TOR_19,"Lucchesi, Joey",1486,0,-2,1484,0.48,"Thornton, Trent",1471,3,24,1498,0.52
348,01_57_TB_CLE_19,"Snell, Blake",1539,36,0,1575,0.53,"Bieber, Shane",1533,-1,24,1556,0.47
349,01_57_DET_NYM_19,"Soto, Gregory",1426,-12,-2,1412,0.31,"Syndergaard, Noah",1514,12,24,1550,0.69
350,01_57_BOS_HOU_20,"Sale, Chris",1554,38,-3,1589,0.5,"Miley, Wade",1583,-15,24,1592,0.5
351,01_57_PHI_MIL_20,"Eickhoff, Jerad",1525,-4,-1,1520,0.43,"Anderson, Chase",1537,8,26,1571,0.57
352,01_57_CHW_MIN_20,"Lopez, Reynaldo",1462,14,-3,1473,0.35,"Berrios, Jose",1542,14,20,1576,0.65
353,01_57_NYY_KC_20,"Green, Chad",1573,-37,-3,1533,0.58,"Junis, Jakob",1451,2,24,1477,0.42
354,01_57_ATL_STL_20,"Foltynewicz, Mike",1520,-1,-4,1515,0.43,"Mikolas, Miles",1525,15,26,1566,0.57
355,01_57_BAL_COL_20,"Means, John",1410,19,-4,1425,0.38,"Hoffman, Jeff",1510,-19,21,1512,0.62
356,01_57_SEA_OAK_22,"LeBlanc, Wade",1482,-3,-2,1477,0.41,"Mengden, Daniel",1520,-2,22,1540,0.59
357,01_57_TEX_LAA_22,"Smyly, Drew",1478,5,-1,1482,0.44,"Canning, Griffin",1496,6,24,1526,0.56
358,01_57_ARI_SF_22,"Ray, Robbie",1507,11,0,1518,0.56,"Pomeranz, Drew",1459,-7,24,1476,0.44
359,01_58_CHW_MIN_14,"Banuelos, Manny",1460,-25,0,1435,0.31,"Gibson, Kyle",1544,3,24,1571,0.69
360,01_58_NYY_KC_14,"Happ, J.A.",1573,-11,-1,1561,0.62,"Junis, Jakob",1451,2,27,1480,0.38
361,01_58_CIN_CHC_14,"Mahle, Tyler",1504,-13,0,1491,0.42,"Darvish, Yu",1537,-11,24,1550,0.58
362,01_58_SD_TOR_15,"Quantrill, Cal",1488,-14,0,1474,0.5,"Jackson, Edwin",1469,-17,24,1476,0.5
363,01_58_ARI_SF_16,"Clarke, Taylor",1507,-17,0,1490,0.51,"Suarez, Andrew",1459,1,24,1484,0.49
364,01_58_MIA_WSH_16,"Alcantara, Sandy",1428,-10,0,1418,0.31,"Corbin, Patrick",1512,17,24,1553,0.69
365,01_58_SEA_OAK_16,"Kikuchi, Yusei",1482,22,0,1504,0.43,"Fiers, Mike",1520,7,24,1551,0.57
366,01_58_TB_CLE_16,"Morton, Charlie",1538,9,0,1547,0.47,"Carrasco, Carlos",1535,10,24,1569,0.53
367,01_58_PHI_MIL_16,"Arrieta, Jake",1527,-2,0,1525,0.44,"Chacin, Jhoulys",1535,9,24,1568,0.56
368,01_58_DET_NYM_16,"Carpenter, Ryan",1427,-35,0,1392,0.33,"Vargas, Jason",1512,-20,24,1516,0.67
369,01_58_BOS_HOU_19,"Price, David",1553,14,0,1567,0.45,"Peacock, Brad",1585,-8,24,1601,0.55
370,01_58_LAD_PIT_19,"Ryu, Hyun-Jin",1573,13,0,1586,0.59,"Musgrove, Joe",1494,3,24,1521,0.41
371,01_58_ATL_STL_19,"Soroka, Mike",1522,24,0,1546,0.53,"Hudson, Dakota",1523,-20,24,1527,0.47
372,01_58_BAL_COL_21,"Cashner, Andrew",1409,6,0,1415,0.32,"Freeland, Kyle",1511,7,24,1542,0.68
373,01_58_TEX_LAA_22,"Minor, Mike",1478,39,0,1517,0.49,"Skaggs, Tyler",1496,3,24,1523,0.51
374,01_59_SD_TOR_13,"Paddack, Chris",1492,27,0,1519,0.53,"Stroman, Marcus",1465,10,24,1499,0.47
375,01_59_TB_CLE_13,"Stanek, Ryne",1540,-19,0,1521,0.43,"Bauer, Trevor",1533,12,24,1569,0.57
376,01_59_DET_NYM_13,"Turnbull, Spencer",1427,17,0,1444,0.36,"Wheeler, Zack",1513,10,24,1547,0.64
377,01_59_LAD_PIT_13,"Maeda, Kenta",1575,-12,0,1563,0.57,"Archer, Chris",1492,-4,24,1512,0.43
378,01_59_MIA_WSH_13,"Smith, Caleb",1427,22,0,1449,0.43,"Fedde, Erick",1514,-40,24,1498,0.57
379,01_59_BOS_HOU_14,"Rodriguez, Eduardo",1552,-9,0,1543,0.35,"Verlander, Justin",1585,40,24,1649,0.65
380,01_59_PHI_MIL_14,"Eflin, Zach",1530,1,0,1531,0.45,"Woodruff, Brandon",1533,9,24,1566,0.55
381,01_59_CHW_MIN_14,"Covey, Dylan",1459,-12,0,1447,0.31,"Odorizzi, Jake",1545,15,24,1584,0.69
382,01_59_NYY_KC_14,"German, Domingo",1575,-7,0,1568,0.62,"Duffy, Danny",1448,14,24,1486,0.38
383,01_59_CIN_CHC_14,"Roark, Tanner",1503,2,0,1505,0.41,"Quintana, Jose",1538,5,24,1567,0.59
384,01_59_BAL_COL_15,"Hess, David",1411,-11,0,1400,0.27,"Marquez, German",1509,38,24,1571,0.73
385,01_59_ARI_SF_16,"Weaver, Luke",1513,2,0,1515,0.55,"Anderson, Shaun",1452,3,24,1479,0.45
386,01_59_TEX_LAA_16,"Jurado, Ariel",1479,-12,0,1467,0.41,"Heaney, Andrew",1495,11,24,1530,0.59
387,01_59_SEA_OAK_16,"Leake, Mike",1479,0,0,1479,0.41,"Anderson, Brett",1522,-6,24,1540,0.59
388,01_59_ATL_STL_19,"Teheran, Julio",1520,10,0,1530,0.45,"Flaherty, Jack",1525,15,24,1564,0.55
389,01_60_MIA_WSH_13,"Urena, Jose",1425,1,0,1426,0.3,"Scherzer, Max",1515,31,24,1570,0.7
390,01_60_DET_BAL_13,"Norris, Daniel",1426,3,-2,1427,0.48,"Ynoa, Gabriel",1411,8,20,1439,0.52
391,01_60_SD_NYY_13,"Strahm, Matt",1489,14,-2,1501,0.37,Pitcher TBD,1574,-3,21,1592,0.63
392,01_60_PIT_CIN_13,"Kingham, Nick",1490,-38,-2,1450,0.36,"Castillo, Luis",1506,25,22,1553,0.64
393,01_60_TOR_TB_13,"Sanchez, Aaron",1468,2,-3,1467,0.39,"Chirinos, Yonny",1542,-15,21,1548,0.61
394,01_60_KC_CHW_14,"Bailey, Homer",1450,-22,-2,1426,0.44,"Nova, Ivan",1457,-13,22,1466,0.56
395,01_60_CHC_HOU_14,"Hamels, Cole",1535,7,-3,1539,0.38,"Cole, Gerrit",1583,13,24,1620,0.62
396,01_60_ARI_COL_15,"Greinke, Zack",1515,35,-3,1547,0.52,"Gray, Jon",1509,1,24,1534,0.48
397,01_60_CLE_BOS_16,"Rodriguez, Jefry",1531,-43,-3,1485,0.39,"Porcello, Rick",1554,-10,20,1564,0.61
398,01_60_LAA_OAK_16,"Cahill, Trevor",1497,-4,-2,1491,0.41,"Bassitt, Chris",1524,6,24,1554,0.59
399,01_60_PIT_CIN_19,"Keller, Mitch",1490,-12,0,1478,0.42,"Gray, Sonny",1506,3,24,1533,0.58
400,01_60_MIL_MIN_19,"Gonzalez, Gio",1535,1,-2,1534,0.47,"Pineda, Michael",1547,-17,24,1554,0.53
401,01_60_NYM_LAD_20,"deGrom, Jacob",1513,40,-4,1549,0.43,"Kershaw, Clayton",1577,5,20,1602,0.57
402,01_60_TEX_SEA_21,"Lynn, Lance",1477,11,-3,1485,0.5,"Milone, Tommy",1477,-11,21,1487,0.5
403,01_61_SD_NYY_18,"Lauer, Eric",1488,-8,0,1480,0.31,"Tanaka, Masahiro",1575,18,24,1617,0.69
404,01_61_PIT_CIN_18,"Lyles, Jordan",1490,-5,0,1485,0.48,"Sims, Lucas",1506,-32,24,1498,0.52
405,01_61_DET_BAL_19,"Boyd, Matthew",1425,30,0,1455,0.51,"Bundy, Dylan",1412,12,24,1448,0.49
406,01_61_STL_PHI_19,"Wainwright, Adam",1523,-13,-1,1509,0.47,"Pivetta, Nick",1527,-20,23,1530,0.53
407,01_61_CLE_BOS_19,"Plesac, Zach",1529,-35,0,1494,0.36,"Price, David",1556,12,24,1592,0.64
408,01_61_SF_MIA_19,"Samardzija, Jeff",1451,6,-2,1455,0.51,"Richards, Trevor",1427,-2,21,1446,0.49
409,01_61_TOR_TB_19,"Richard, Clayton",1466,-22,0,1444,0.35,"Stanek, Ryne",1543,-19,24,1548,0.65
410,01_61_WSH_ATL_19,"Strasburg, Stephen",1513,20,-3,1530,0.47,"Fried, Max",1521,8,24,1553,0.53
411,01_61_KC_CHW_20,"Keller, Brad",1450,16,0,1466,0.45,"Giolito, Lucas",1457,22,24,1503,0.55
412,01_61_CHC_HOU_20,"Lester, Jon",1534,-1,0,1533,0.45,"Martin, Corbin",1584,-43,24,1565,0.55
413,01_61_MIL_MIN_20,"Davies, Zach",1537,5,0,1542,0.48,"Perez, Martin",1545,-16,24,1553,0.52
414,01_61_ARI_COL_20,"Kelly, Merrill",1514,-27,0,1487,0.46,"Senzatela, Antonio",1510,-18,24,1516,0.54
415,01_61_TEX_SEA_22,"Sampson, Adrian",1475,-20,0,1455,0.41,"Gonzales, Marco",1479,16,24,1519,0.59
416,01_61_LAA_OAK_22,"Tropeano, Nick",1495,-2,0,1493,0.4,"Montas, Frankie",1526,14,24,1564,0.6
417,01_61_NYM_LAD_22,"Matz, Steven",1512,-14,0,1498,0.35,"Hill, Rich",1578,2,24,1604,0.65
418,01_62_PIT_CIN_12,"Brault, Steven",1488,-24,0,1464,0.42,"DeSclafani, Anthony",1508,-15,24,1517,0.58
419,01_62_SD_NYY_13,"Paddack, Chris",1490,27,0,1517,0.36,"Paxton, James",1574,15,24,1613,0.64
420,01_62_LAA_OAK_15,"Canning, Griffin",1495,8,0,1503,0.44,"Mengden, Daniel",1526,-2,24,1548,0.56
421,01_62_TEX_SEA_15,"Smyly, Drew",1475,3,0,1478,0.47,"LeBlanc, Wade",1479,-3,24,1500,0.53
422,01_62_CLE_BOS_18,"Bieber, Shane",1531,2,0,1533,0.48,"Weber, Ryan",1555,-35,24,1544,0.52
423,01_62_DET_BAL_19,"Carpenter, Ryan",1426,-29,0,1397,0.42,"Means, John",1410,18,24,1452,0.58
424,01_62_STL_PHI_19,"Cabrera, Genesis",1522,-13,0,1509,0.4,"Nola, Aaron",1528,26,24,1578,0.6
425,01_62_SF_MIA_19,"Bumgarner, Madison",1447,29,0,1476,0.54,"Lopez, Pablo",1430,-4,24,1450,0.46
426,01_62_TOR_TB_19,"Thornton, Trent",1465,6,0,1471,0.32,"Snell, Blake",1544,35,24,1603,0.68
427,01_62_WSH_ATL_19,"Sanchez, Anibal",1514,-22,0,1492,0.42,"Gausman, Kevin",1520,2,24,1546,0.58
428,01_62_CHC_HOU_20,"Hendricks, Kyle",1533,19,0,1552,0.44,"Miley, Wade",1585,-13,24,1596,0.56
429,01_62_KC_CHW_20,"Sparkman, Glenn",1448,11,0,1459,0.46,"Lopez, Reynaldo",1459,5,24,1488,0.54
430,01_62_ARI_COL_20,"Ray, Robbie",1512,10,0,1522,0.51,"Hoffman, Jeff",1512,-20,24,1516,0.49
431,01_62_NYM_LAD_22,"Syndergaard, Noah",1512,7,0,1519,0.36,"Buehler, Walker",1578,15,24,1617,0.64
432,01_63_STL_PHI_13,"Hudson, Dakota",1520,-16,0,1504,0.44,"Eickhoff, Jerad",1530,-8,24,1546,0.56
433,01_63_SF_MIA_13,"Beede, Tyler",1446,-20,0,1426,0.48,"Alcantara, Sandy",1432,-13,24,1443,0.52
434,01_63_ARI_COL_15,"Clarke, Taylor",1511,-18,0,1493,0.44,"Freeland, Kyle",1513,1,24,1538,0.56
435,01_63_BOS_NYY_19,"Sale, Chris",1552,37,-2,1587,0.49,"Happ, J.A.",1575,-6,24,1593,0.51
436,01_63_MIL_PIT_19,"Anderson, Chase",1535,6,-1,1540,0.54,"Musgrove, Joe",1491,1,22,1514,0.46
437,01_63_MIN_TB_19,"Perez, Martin",1547,-17,-1,1529,0.43,"Morton, Charlie",1545,12,24,1581,0.57
438,01_63_KC_TEX_20,"Junis, Jakob",1447,5,-3,1449,0.37,"Minor, Mike",1480,39,20,1539,0.63
439,01_63_CLE_CHW_20,"Carrasco, Carlos",1533,7,-3,1537,0.61,"Banuelos, Manny",1460,-26,24,1458,0.39
440,01_63_NYM_LAD_22,"Vargas, Jason",1514,-20,0,1494,0.34,"Ryu, Hyun-Jin",1576,12,24,1612,0.66
441,01_63_LAA_SEA_22,Pitcher TBD,1500,1,-3,1498,0.48,"Kikuchi, Yusei",1475,13,24,1512,0.52
442,01_64_SF_BAL_19,"Pomeranz, Drew",1447,-8,-3,1436,0.5,"Cashner, Andrew",1409,4,26,1439,0.5
443,01_64_BOS_NYY_19,"Sale, Chris",1552,37,0,1589,0.49,"Happ, J.A.",1575,-6,26,1595,0.51
444,01_64_MIL_PIT_19,"Chacin, Jhoulys",1537,3,0,1540,0.55,"Archer, Chris",1489,-5,24,1508,0.45
445,01_64_WSH_CIN_19,"Corbin, Patrick",1519,19,0,1538,0.53,"Mahle, Tyler",1506,-18,26,1514,0.47
446,01_64_MIN_TB_19,"Berrios, Jose",1544,10,0,1554,0.5,"Stanek, Ryne",1548,-19,24,1553,0.5
447,01_64_DET_ATL_19,"Turnbull, Spencer",1428,16,-1,1443,0.36,"Foltynewicz, Mike",1516,5,26,1547,0.64
448,01_64_KC_TEX_20,"Duffy, Danny",1449,15,0,1464,0.46,"Jurado, Ariel",1478,-10,24,1492,0.54
449,01_64_CLE_CHW_20,"Bauer, Trevor",1530,14,0,1544,0.59,"Covey, Dylan",1463,-10,24,1477,0.41
450,01_64_CHC_STL_20,"Darvish, Yu",1534,-14,-1,1519,0.45,"Mikolas, Miles",1522,14,21,1557,0.55
451,01_64_TOR_COL_20,"Jackson, Edwin",1465,-21,-2,1442,0.32,"Marquez, German",1514,38,24,1576,0.68
452,01_64_NYM_ARI_21,"Wheeler, Zack",1513,10,-2,1521,0.51,"Duplantier, Jon",1510,-19,21,1512,0.49
453,01_64_HOU_OAK_22,"Peacock, Brad",1584,-4,-2,1578,0.53,"Fiers, Mike",1521,9,26,1556,0.47
454,01_64_PHI_LAD_22,"Arrieta, Jake",1529,2,-4,1527,0.41,"Maeda, Kenta",1577,-12,24,1589,0.59
455,01_64_MIA_SD_22,"Smith, Caleb",1430,15,-4,1441,0.4,"Lucchesi, Joey",1488,1,22,1511,0.6
456,01_64_LAA_SEA_22,"Skaggs, Tyler",1500,6,0,1506,0.51,"Leake, Mike",1475,1,24,1500,0.49
457,01_65_MIN_TB_13,"Gibson, Kyle",1545,4,0,1549,0.48,"Chirinos, Yonny",1546,-9,24,1561,0.52
458,01_65_CLE_CHW_14,"Rodriguez, Jefry",1527,-44,0,1483,0.51,"Nova, Ivan",1466,-11,24,1479,0.49
459,01_65_SF_BAL_16,"Anderson, Shaun",1446,-3,0,1443,0.53,"Hess, David",1410,-11,24,1423,0.47
460,01_65_MIL_PIT_16,"Woodruff, Brandon",1535,16,0,1551,0.6,"Kingham, Nick",1491,-36,24,1479,0.4
461,01_65_KC_TEX_16,"Bailey, Homer",1447,-18,0,1429,0.38,"Lynn, Lance",1480,11,24,1515,0.62
462,01_65_DET_ATL_16,"Norris, Daniel",1431,1,0,1432,0.32,"Soroka, Mike",1513,29,24,1566,0.68
463,01_65_WSH_CIN_16,"Fedde, Erick",1516,-37,0,1479,0.42,"Roark, Tanner",1508,4,24,1536,0.58
464,01_65_BOS_NYY_19,"Porcello, Rick",1551,-11,0,1540,0.43,"German, Domingo",1577,-14,24,1587,0.57
465,01_65_LAA_SEA_19,"Heaney, Andrew",1501,11,0,1512,0.53,"Milone, Tommy",1473,-6,24,1491,0.47
466,01_65_CHC_STL_19,"Quintana, Jose",1533,0,0,1533,0.45,"Flaherty, Jack",1523,19,24,1566,0.55
467,01_65_TOR_COL_21,"Stroman, Marcus",1463,13,0,1476,0.41,"Gray, Jon",1515,3,24,1542,0.59
468,01_65_MIA_SD_22,"Urena, Jose",1430,3,0,1433,0.42,"Margevicius, Nick",1488,-24,24,1488,0.58
469,01_65_HOU_OAK_22,"Verlander, Justin",1584,39,0,1623,0.61,"Anderson, Brett",1521,-3,24,1542,0.39
470,01_65_NYM_ARI_22,"deGrom, Jacob",1514,36,0,1550,0.47,"Greinke, Zack",1509,38,24,1571,0.53
471,01_65_PHI_LAD_22,"Irvin, Cole",1529,-18,0,1511,0.37,"Kershaw, Clayton",1577,2,24,1603,0.63
472,01_66_SF_BAL_13,"Samardzija, Jeff",1448,3,0,1451,0.51,"Ynoa, Gabriel",1408,9,24,1441,0.49
473,01_66_WSH_CIN_13,"Scherzer, Max",1518,31,0,1549,0.52,"Gray, Sonny",1506,6,24,1536,0.48
474,01_66_MIN_TB_13,"Odorizzi, Jake",1547,17,0,1564,0.52,"Yarbrough, Ryan",1544,-21,24,1547,0.48
475,01_66_DET_ATL_13,"Boyd, Matthew",1430,32,0,1462,0.38,"Teheran, Julio",1514,12,24,1550,0.62
476,01_66_MIL_PIT_13,"Davies, Zach",1536,11,0,1547,0.55,"Lyles, Jordan",1490,-5,24,1509,0.45
477,01_66_CLE_CHW_14,"Plesac, Zach",1529,-26,0,1503,0.48,"Giolito, Lucas",1464,26,24,1514,0.52
478,01_66_CHC_STL_14,"Hamels, Cole",1533,1,0,1534,0.5,"Wainwright, Adam",1523,-13,24,1534,0.5
479,01_66_KC_TEX_15,"Keller, Brad",1446,15,0,1461,0.47,"Sampson, Adrian",1481,-20,24,1485,0.53
480,01_66_TOR_COL_15,"Sanchez, Aaron",1462,3,0,1465,0.42,"Senzatela, Antonio",1516,-18,24,1522,0.58
481,01_66_PHI_LAD_16,"Pivetta, Nick",1526,-18,0,1508,0.37,"Hill, Rich",1579,0,24,1603,0.63
482,01_66_HOU_OAK_16,"Cole, Gerrit",1586,16,0,1602,0.58,"Bassitt, Chris",1519,4,24,1547,0.42
483,01_66_NYM_ARI_16,"Matz, Steven",1514,-13,0,1501,0.48,"Kelly, Merrill",1509,-21,24,1512,0.52
484,01_66_LAA_SEA_16,"Suarez, Jose",1503,-6,0,1497,0.48,"Gonzales, Marco",1472,12,24,1508,0.52
485,01_66_MIA_SD_18,"Richards, Trevor",1432,0,0,1432,0.37,"Strahm, Matt",1486,15,24,1525,0.63
486,01_66_BOS_NYY_19,"Price, David",1550,18,0,1568,0.46,"Sabathia, CC",1578,-11,24,1591,0.54
487,01_67_LAA_CHC_16,"Cahill, Trevor",1506,-8,-4,1494,0.43,"Lester, Jon",1530,-8,22,1544,0.57
488,01_67_LAD_ARI_21,"Buehler, Walker",1581,8,-2,1587,0.56,"Ray, Robbie",1513,8,24,1545,0.44
489,01_67_PHI_SD_22,"Nola, Aaron",1524,29,-1,1552,0.57,"Lauer, Eric",1483,-3,24,1504,0.43
490,01_67_HOU_SEA_22,"Martin, Corbin",1588,-49,-3,1536,0.56,"LeBlanc, Wade",1468,2,24,1494,0.44
491,01_68_ATL_PIT_19,"Fried, Max",1515,9,0,1524,0.54,"Brault, Steven",1489,-17,26,1498,0.46
492,01_68_CHW_WSH_19,"Lopez, Reynaldo",1465,0,-1,1464,0.36,"Strasburg, Stephen",1519,21,24,1564,0.64
493,01_68_NYY_TOR_19,"Tanaka, Masahiro",1576,14,0,1590,0.68,"Richard, Clayton",1461,-20,23,1464,0.32
494,01_68_MIN_CLE_19,"Smeltzer, Devin",1549,-12,-1,1536,0.48,"Bieber, Shane",1527,-2,24,1549,0.52
495,01_68_TB_DET_19,"Snell, Blake",1543,33,-1,1575,0.7,"Carpenter, Ryan",1429,-26,23,1426,0.3
496,01_68_SF_NYM_19,"Bumgarner, Madison",1451,28,0,1479,0.42,"Syndergaard, Noah",1510,5,22,1537,0.58
497,01_68_MIA_MIL_19,"Lopez, Pablo",1435,-3,-2,1430,0.31,"Anderson, Chase",1537,7,24,1568,0.69
498,01_68_BOS_KC_20,"Rodriguez, Eduardo",1551,-4,-1,1546,0.61,"Sparkman, Glenn",1444,2,24,1470,0.39
499,01_68_COL_CHC_20,"Hoffman, Jeff",1518,-20,-1,1497,0.39,"Hendricks, Kyle",1533,21,24,1578,0.61
500,01_68_BAL_TEX_20,"Bundy, Dylan",1405,15,-1,1419,0.37,"Smyly, Drew",1483,1,26,1510,0.63
501,01_68_CIN_STL_20,"Castillo, Luis",1505,22,0,1527,0.49,"Cabrera, Genesis",1525,-20,26,1531,0.51
502,01_68_LAD_ARI_21,"Ryu, Hyun-Jin",1582,14,0,1596,0.62,"Clarke, Taylor",1511,-23,24,1512,0.38
503,01_68_OAK_LAA_22,"Montas, Frankie",1518,11,0,1529,0.49,"Canning, Griffin",1504,14,20,1538,0.51
504,01_68_PHI_SD_22,"Eickhoff, Jerad",1524,-10,0,1514,0.48,"Paddack, Chris",1483,24,24,1531,0.52
505,01_68_HOU_SEA_22,"Miley, Wade",1588,-12,0,1576,0.62,Pitcher TBD,1468,2,24,1494,0.38
506,01_69_CHW_WSH_13,"Covey, Dylan",1464,-8,0,1456,0.39,"Sanchez, Anibal",1521,-15,24,1530,0.61
507,01_69_LAD_ARI_15,"Maeda, Kenta",1585,-14,0,1571,0.58,"Duplantier, Jon",1509,-20,24,1513,0.42
508,01_69_PHI_SD_15,"Arrieta, Jake",1522,-3,0,1519,0.5,"Lucchesi, Joey",1486,5,24,1515,0.5
509,01_69_ATL_PIT_19,"Gausman, Kevin",1517,-4,0,1513,0.51,"Musgrove, Joe",1486,-2,24,1508,0.49
510,01_69_NYY_TOR_19,"Paxton, James",1575,18,0,1593,0.64,"Thornton, Trent",1462,5,24,1491,0.36
511,01_69_MIN_CLE_19,"Perez, Martin",1547,-21,0,1526,0.46,"Carrasco, Carlos",1529,3,24,1556,0.54
512,01_69_TB_DET_19,"Morton, Charlie",1541,17,0,1558,0.62,"Turnbull, Spencer",1432,17,24,1473,0.38
513,01_69_SF_NYM_19,"Beede, Tyler",1454,-15,0,1439,0.39,"Vargas, Jason",1507,-17,24,1514,0.61
514,01_69_MIA_MIL_19,"Alcantara, Sandy",1442,-12,0,1430,0.31,"Nelson, Jimmy",1530,15,24,1569,0.69
515,01_69_COL_CHC_20,"Marquez, German",1517,37,0,1554,0.51,"Darvish, Yu",1534,-13,24,1545,0.49
516,01_69_BAL_TEX_20,"Means, John",1407,27,0,1434,0.35,"Minor, Mike",1481,36,24,1541,0.65
517,01_69_BOS_KC_20,"Sale, Chris",1553,36,0,1589,0.66,"Junis, Jakob",1443,7,24,1474,0.34
518,01_69_CIN_STL_20,"DeSclafani, Anthony",1507,-16,0,1491,0.44,"Hudson, Dakota",1524,-12,24,1536,0.56
519,01_69_OAK_LAA_22,"Mengden, Daniel",1518,-2,0,1516,0.46,"Pena, Felix",1504,12,24,1540,0.54
520,01_69_HOU_SEA_22,"Peacock, Brad",1589,-4,0,1585,0.62,"Leake, Mike",1467,6,24,1497,0.38
521,01_70_SF_NYM_12,"Anderson, Shaun",1452,3,0,1455,0.38,"Wheeler, Zack",1509,9,24,1542,0.62
522,01_70_ATL_PIT_12,"Foltynewicz, Mike",1516,3,0,1519,0.51,"Archer, Chris",1488,-3,24,1509,0.49
523,01_70_TB_DET_13,"Stanek, Ryne",1542,-18,0,1524,0.6,"Norris, Daniel",1430,-3,24,1451,0.4
524,01_70_BOS_KC_13,"Weber, Ryan",1555,-44,0,1511,0.55,"Duffy, Danny",1441,13,24,1478,0.45
525,01_70_CIN_STL_13,"DeSclafani, Anthony",1507,-16,2,1493,0.44,"Hudson, Dakota",1524,-12,26,1538,0.56
526,01_70_MIA_MIL_14,"Smith, Caleb",1446,11,0,1457,0.38,"Peralta, Freddy",1527,-10,24,1541,0.62
527,01_70_COL_CHC_14,"Lambert, Peter",1515,-21,0,1494,0.41,"Quintana, Jose",1535,-3,24,1556,0.59
528,01_70_HOU_SEA_15,"Verlander, Justin",1590,42,0,1632,0.7,"Milone, Tommy",1465,-5,24,1484,0.3
529,01_70_MIN_CLE_19,"Berrios, Jose",1546,11,0,1557,0.49,"Bauer, Trevor",1530,12,24,1566,0.51
530,01_70_NYY_TOR_19,"Happ, J.A.",1572,-3,0,1569,0.65,"Jackson, Edwin",1465,-28,24,1461,0.35
531,01_70_BAL_TEX_20,"Hess, David",1406,-15,0,1391,0.35,"Jurado, Ariel",1482,-7,24,1499,0.65
532,01_70_OAK_LAA_22,"Fiers, Mike",1519,9,0,1528,0.49,"Skaggs, Tyler",1502,6,24,1532,0.51
533,01_70_WSH_SD_22,"Corbin, Patrick",1522,9,-4,1527,0.52,"Lucchesi, Joey",1482,6,24,1512,0.48
534,01_71_STL_CHC_14,"Mikolas, Miles",1525,15,-2,1538,0.47,"Hamels, Cole",1533,3,24,1560,0.53
535,01_71_CIN_PHI_19,"Mahle, Tyler",1505,-18,-3,1484,0.41,"Eflin, Zach",1525,1,22,1548,0.59
536,01_71_ARI_TOR_19,"Kelly, Merrill",1510,-13,-2,1495,0.49,"Stroman, Marcus",1464,16,24,1504,0.51
537,01_71_TB_BOS_19,"Chirinos, Yonny",1543,-10,-3,1530,0.46,"Porcello, Rick",1556,-15,21,1562,0.54
538,01_71_NYY_CLE_19,"German, Domingo",1573,-14,-2,1557,0.54,"Plesac, Zach",1529,-20,24,1533,0.46
539,01_71_MIN_DET_19,Pitcher TBD,1547,1,-1,1547,0.59,"Boyd, Matthew",1429,31,24,1484,0.41
540,01_71_ATL_MIA_19,"Soroka, Mike",1513,30,-3,1540,0.61,"Urena, Jose",1444,1,21,1466,0.39
541,01_71_COL_NYM_19,"Senzatela, Antonio",1517,-14,-3,1500,0.4,"deGrom, Jacob",1511,37,24,1572,0.6
542,01_71_OAK_TEX_20,"Anderson, Brett",1518,-4,-3,1511,0.49,"Lynn, Lance",1482,14,24,1520,0.51
543,01_71_BAL_HOU_20,"Ynoa, Gabriel",1405,6,-2,1409,0.23,"Cole, Gerrit",1586,15,20,1621,0.77
544,01_71_PIT_MIL_20,"Davis, Rookie",1491,-33,-2,1456,0.35,"Woodruff, Brandon",1528,11,24,1563,0.65
545,01_71_CHW_KC_20,"Nova, Ivan",1463,-11,-1,1451,0.51,"Bailey, Homer",1440,-19,24,1445,0.49
546,01_71_SEA_LAA_22,"Gonzales, Marco",1470,4,-3,1471,0.4,"Heaney, Andrew",1503,11,24,1538,0.6
547,01_71_WSH_SD_22,"Fedde, Erick",1522,-38,0,1484,0.51,"Margevicius, Nick",1482,-29,24,1477,0.49
548,01_71_LAD_SF_22,"Kershaw, Clayton",1583,0,-1,1582,0.68,"Pomeranz, Drew",1450,-16,20,1454,0.32
549,01_72_TB_BOS_13,Pitcher TBD,1546,0,0,1546,0.43,"Price, David",1554,17,24,1595,0.57
550,01_72_OAK_TEX_14,"Blackburn, Paul",1521,-12,0,1509,0.52,"Palumbo, Joe",1481,-11,24,1494,0.48
551,01_72_CHW_KC_14,"Giolito, Lucas",1462,31,0,1493,0.52,"Keller, Brad",1441,17,24,1482,0.48
552,01_72_ARI_TOR_15,"Greinke, Zack",1513,30,0,1543,0.58,"Sanchez, Aaron",1461,4,24,1489,0.42
553,01_72_CIN_PHI_16,"Roark, Tanner",1504,2,0,1506,0.45,"Pivetta, Nick",1526,-10,24,1540,0.55
554,01_72_NYY_CLE_16,"Sabathia, CC",1572,-9,0,1563,0.57,"Plutko, Adam",1531,-43,24,1512,0.43
555,01_72_MIN_DET_16,"Gibson, Kyle",1548,5,0,1553,0.64,Pitcher TBD,1427,0,24,1451,0.36
556,01_72_ATL_MIA_16,"Teheran, Julio",1515,15,0,1530,0.58,"Richards, Trevor",1442,4,24,1470,0.42
557,01_72_BAL_HOU_16,"Cashner, Andrew",1405,-1,0,1404,0.27,"Valdez, Framber",1586,-31,24,1579,0.73
558,01_72_PIT_MIL_16,"Lyles, Jordan",1489,-5,0,1484,0.38,"Davies, Zach",1530,13,24,1567,0.62
559,01_72_TB_BOS_18,Pitcher TBD,1546,0,0,1546,0.45,Pitcher TBD,1554,0,24,1578,0.55
560,01_72_STL_CHC_19,"Flaherty, Jack",1524,19,0,1543,0.48,"Lester, Jon",1534,-6,24,1552,0.52
561,01_72_COL_NYM_19,"Gray, Jon",1520,7,0,1527,0.52,"Matz, Steven",1508,-18,24,1514,0.48
562,01_72_LAD_SF_19,"Hill, Rich",1582,1,0,1583,0.64,"Samardzija, Jeff",1452,7,24,1483,0.36
563,01_72_OAK_TEX_21,"Bassitt, Chris",1521,5,0,1526,0.55,"Sampson, Adrian",1481,-11,24,1494,0.45
564,01_72_WSH_SD_22,"Scherzer, Max",1521,37,0,1558,0.57,"Lauer, Eric",1484,1,24,1509,0.43
565,01_72_SEA_LAA_22,"Kikuchi, Yusei",1470,1,0,1471,0.42,Pitcher TBD,1502,2,24,1528,0.58
566,01_73_TB_BOS_13,"Snell, Blake",1547,24,0,1571,0.5,"Rodriguez, Eduardo",1552,-4,24,1572,0.5
567,01_73_CIN_PHI_13,"Gray, Sonny",1503,6,0,1509,0.41,"Nola, Aaron",1527,22,24,1573,0.59
568,01_73_ARI_TOR_13,"Ray, Robbie",1515,8,0,1523,0.58,"Richard, Clayton",1459,-17,24,1466,0.42
569,01_73_NYY_CLE_13,"Green, Chad",1569,-31,0,1538,0.47,"Bieber, Shane",1533,0,24,1557,0.53
570,01_73_MIN_DET_13,"Odorizzi, Jake",1544,23,0,1567,0.68,"Carpenter, Ryan",1431,-20,24,1435,0.32
571,01_73_ATL_MIA_13,"Fried, Max",1516,3,0,1519,0.57,"Lopez, Pablo",1442,2,24,1468,0.43
572,01_73_COL_NYM_13,"Hoffman, Jeff",1518,-20,0,1498,0.44,"Syndergaard, Noah",1510,3,24,1537,0.56
573,01_73_BAL_HOU_14,"Bundy, Dylan",1408,12,0,1420,0.27,"Miley, Wade",1583,-13,24,1594,0.73
574,01_73_PIT_MIL_14,"Brault, Steven",1488,-17,0,1471,0.38,"Anderson, Chase",1531,3,24,1558,0.62
575,01_73_CHW_KC_14,"Lopez, Reynaldo",1463,-6,0,1457,0.48,"Sparkman, Glenn",1440,8,24,1472,0.52
576,01_73_OAK_TEX_15,"Montas, Frankie",1518,13,0,1531,0.54,"Smyly, Drew",1485,-9,24,1500,0.46
577,01_73_SEA_LAA_16,"LeBlanc, Wade",1472,0,0,1472,0.44,"Suarez, Jose",1499,-6,24,1517,0.56
578,01_73_LAD_SF_16,"Buehler, Walker",1583,12,0,1595,0.63,"Bumgarner, Madison",1450,26,24,1500,0.37
579,01_73_WSH_SD_16,"Strasburg, Stephen",1521,17,0,1538,0.53,"Paddack, Chris",1483,12,24,1519,0.47
580,01_73_STL_CHC_19,"Wainwright, Adam",1521,-6,0,1515,0.41,"Hendricks, Kyle",1537,19,24,1580,0.59
581,01_74_OAK_TB_19,"Anderson, Tanner",1519,-9,-3,1507,0.39,"Morton, Charlie",1549,17,21,1587,0.61
582,01_74_NYM_NYY_19,"Vargas, Jason",1512,-13,-1,1498,0.35,"Tanaka, Masahiro",1570,11,22,1603,0.65
583,01_74_ARI_PHI_19,"Clarke, Taylor",1517,-21,-2,1494,0.43,"Eickhoff, Jerad",1526,-8,24,1542,0.57
584,01_74_TEX_BOS_19,"Minor, Mike",1484,36,-4,1516,0.36,"Sale, Chris",1550,43,24,1617,0.64
585,01_74_STL_MIA_19,"Wacha, Michael",1520,-14,-3,1503,0.56,"Alcantara, Sandy",1441,-6,24,1459,0.44
586,01_74_PIT_ATL_19,"Musgrove, Joe",1487,1,-3,1485,0.44,"Gausman, Kevin",1517,-12,21,1526,0.56
587,01_74_WSH_CHW_20,"Sanchez, Anibal",1522,-13,-4,1505,0.55,"Despaigne, Odrisamer",1465,-17,22,1470,0.45
588,01_74_CHC_COL_20,"Darvish, Yu",1538,-14,-3,1521,0.43,"Marquez, German",1516,32,20,1568,0.57
589,01_74_LAD_LAA_22,"Ryu, Hyun-Jin",1584,16,-2,1598,0.59,"Canning, Griffin",1499,14,24,1537,0.41
590,01_75_CIN_CLE_19,"Castillo, Luis",1504,23,0,1527,0.44,"Bauer, Trevor",1532,11,26,1569,0.56
591,01_75_NYM_NYY_19,"Vargas, Jason",1512,-13,1,1500,0.35,"Paxton, James",1570,15,24,1609,0.65
592,01_75_TOR_BAL_19,"Thornton, Trent",1457,7,0,1464,0.5,"Means, John",1407,31,23,1461,0.5
593,01_75_ARI_PHI_19,"Duplantier, Jon",1519,-15,0,1504,0.45,"Arrieta, Jake",1523,-9,24,1538,0.55
594,01_75_TEX_BOS_19,"Jurado, Ariel",1485,-8,0,1477,0.37,Pitcher TBD,1549,0,24,1573,0.63
595,01_75_STL_MIA_19,"Hudson, Dakota",1521,-8,0,1513,0.6,"Hernandez, Elieser",1439,-22,24,1441,0.4
596,01_75_OAK_TB_19,"Fiers, Mike",1517,9,0,1526,0.43,Pitcher TBD,1550,0,24,1574,0.57
597,01_75_PIT_ATL_19,"Archer, Chris",1485,-1,0,1484,0.41,"Foltynewicz, Mike",1519,1,24,1544,0.59
598,01_75_WSH_CHW_20,"Corbin, Patrick",1525,3,0,1528,0.6,"Banuelos, Manny",1462,-28,24,1458,0.4
599,01_75_MIL_HOU_20,"Peralta, Freddy",1532,-7,-1,1524,0.39,"Peacock, Brad",1584,-5,26,1605,0.61
600,01_75_SEA_MIN_20,"Leake, Mike",1473,12,-2,1483,0.41,"Perez, Martin",1546,-22,23,1547,0.59
601,01_75_DET_KC_20,"Turnbull, Spencer",1429,17,-1,1445,0.47,"Junis, Jakob",1438,4,26,1468,0.53
602,01_75_CHC_COL_20,"Quintana, Jose",1537,-2,0,1535,0.5,"Lambert, Peter",1517,-9,24,1532,0.5
603,01_75_SD_SF_21,"Paddack, Chris",1482,12,0,1494,0.56,"Beede, Tyler",1450,-23,26,1453,0.44
604,01_75_LAD_LAA_22,"Maeda, Kenta",1584,-11,0,1573,0.55,"Pena, Felix",1499,12,24,1535,0.45
605,01_76_OAK_TB_12,"Anderson, Brett",1518,-4,0,1514,0.41,Pitcher TBD,1549,0,24,1573,0.59
606,01_76_CIN_CLE_13,"DeSclafani, Anthony",1503,-14,0,1489,0.42,"Plesac, Zach",1533,-15,24,1542,0.58
607,01_76_CHC_COL_15,"Hamels, Cole",1535,9,0,1544,0.52,"Senzatela, Antonio",1520,-13,24,1531,0.48
608,01_76_TEX_BOS_16,"Lynn, Lance",1488,14,0,1502,0.42,"Porcello, Rick",1546,-16,24,1554,0.58
609,01_76_TOR_BAL_19,"Jackson, Edwin",1456,-28,0,1428,0.52,"Hess, David",1409,-17,24,1416,0.48
610,01_76_ARI_PHI_19,"Kelly, Merrill",1518,-8,0,1510,0.44,"Eflin, Zach",1525,2,24,1551,0.56
611,01_76_STL_MIA_19,"Mikolas, Miles",1523,14,0,1537,0.62,"Urena, Jose",1437,-9,24,1452,0.38
612,01_76_PIT_ATL_19,"Keller, Mitch",1484,-14,0,1470,0.35,"Soroka, Mike",1520,34,24,1578,0.65
613,01_76_DET_KC_20,"Norris, Daniel",1428,-4,0,1424,0.43,"Duffy, Danny",1439,8,24,1471,0.57
614,01_76_MIL_HOU_20,"Woodruff, Brandon",1531,14,0,1545,0.35,"Verlander, Justin",1585,41,24,1650,0.65
615,01_76_SEA_MIN_20,"Milone, Tommy",1472,-3,0,1469,0.34,"Berrios, Jose",1547,14,24,1585,0.66
616,01_76_SD_SF_21,"Lucchesi, Joey",1481,5,0,1486,0.52,"Anderson, Shaun",1451,-2,24,1473,0.48
617,01_77_PIT_ATL_12,"Musgrove, Joe",1483,3,0,1486,0.39,"Teheran, Julio",1521,20,24,1565,0.61
618,01_77_SEA_MIN_13,"Kikuchi, Yusei",1474,-12,0,1462,0.37,"Pineda, Michael",1545,-14,24,1555,0.63
619,01_77_TOR_BAL_19,"Stroman, Marcus",1457,14,0,1471,0.55,"Ynoa, Gabriel",1407,5,24,1436,0.45
620,01_77_ARI_WSH_19,"Greinke, Zack",1520,31,-2,1549,0.55,"Fedde, Erick",1524,-36,23,1511,0.45
621,01_77_TEX_BOS_19,"Sampson, Adrian",1487,0,0,1487,0.35,"Price, David",1547,19,24,1590,0.65
622,01_77_STL_NYM_19,"Flaherty, Jack",1519,14,-3,1530,0.43,"deGrom, Jacob",1513,37,25,1575,0.57
623,01_77_LAA_TB_19,"Skaggs, Tyler",1502,1,-2,1501,0.43,"Yarbrough, Ryan",1547,-18,24,1553,0.57
624,01_77_DET_KC_20,"Boyd, Matthew",1429,31,0,1460,0.56,"Bailey, Homer",1438,-19,0,1419,0.44
625,01_77_NYY_CHW_20,"Happ, J.A.",1569,2,-1,1570,0.63,"Nova, Ivan",1463,-13,26,1476,0.37
626,01_77_SD_COL_20,"Strahm, Matt",1479,9,-3,1485,0.41,"Gray, Jon",1517,6,24,1547,0.59
627,01_77_CHC_LAD_22,"Lester, Jon",1538,-8,-3,1527,0.39,"Kershaw, Clayton",1581,1,25,1607,0.61
628,01_78_BOS_BAL_19,"Rodriguez, Eduardo",1548,-5,-2,1541,0.65,Pitcher TBD,1405,3,24,1432,0.35
629,01_78_ARI_WSH_19,"Ray, Robbie",1521,9,0,1530,0.42,"Scherzer, Max",1522,40,24,1586,0.58
630,01_78_TEX_CIN_19,"Chavez, Jesse",1486,-18,-3,1465,0.43,"Mahle, Tyler",1506,-18,24,1512,0.57
631,01_78_CLE_DET_19,"Plutko, Adam",1530,-36,1,1495,0.61,"Carpenter, Ryan",1427,-31,21,1417,0.39
632,01_78_PIT_MIA_19,"Brault, Steven",1482,-11,-3,1468,0.49,"Richards, Trevor",1442,5,26,1473,0.51
633,01_78_STL_NYM_19,"Ponce de Leon, Daniel",1519,4,-1,1522,0.5,"Matz, Steven",1513,-16,28,1525,0.5
634,01_78_LAA_TB_19,"Heaney, Andrew",1504,9,0,1513,0.38,"Snell, Blake",1545,25,24,1594,0.62
635,01_78_PHI_ATL_19,"Pivetta, Nick",1523,-4,-1,1518,0.46,"Fried, Max",1521,5,24,1550,0.54
636,01_78_NYY_CHW_20,"Sabathia, CC",1568,-8,0,1560,0.55,"Giolito, Lucas",1465,35,24,1524,0.45
637,01_78_TOR_HOU_20,"Sanchez, Aaron",1460,3,-3,1460,0.28,"Cole, Gerrit",1583,16,26,1625,0.72
638,01_78_KC_MIN_20,"Keller, Brad",1440,17,-2,1455,0.34,"Gibson, Kyle",1546,-1,24,1569,0.66
639,01_78_SD_COL_20,"Quantrill, Cal",1478,-5,0,1473,0.43,"Hoffman, Jeff",1518,-22,24,1520,0.57
640,01_78_SEA_OAK_21,"Gonzales, Marco",1473,6,-4,1475,0.4,"Bassitt, Chris",1521,5,22,1548,0.6
641,01_78_CHC_LAD_22,"Hendricks, Kyle",1536,21,0,1557,0.43,"Hill, Rich",1582,-2,24,1604,0.57
642,01_78_MIL_SF_22,"Davies, Zach",1533,11,-2,1542,0.61,"Pomeranz, Drew",1452,-12,26,1466,0.39
643,01_79_LAA_TB_13,"Suarez, Jose",1503,-6,0,1497,0.36,"Morton, Charlie",1547,23,24,1594,0.64
644,01_79_BOS_BAL_16,"Sale, Chris",1550,47,0,1597,0.71,"Bundy, Dylan",1402,15,24,1441,0.29
645,01_79_MIL_SF_16,"Nelson, Jimmy",1533,9,0,1542,0.55,"Bumgarner, Madison",1452,29,24,1505,0.45
646,01_79_ARI_WSH_16,"Clarke, Taylor",1520,-28,0,1492,0.39,"Strasburg, Stephen",1523,20,24,1567,0.61
647,01_79_TOR_HOU_16,"Richard, Clayton",1458,-20,0,1438,0.3,"Valdez, Framber",1584,-26,24,1582,0.7
648,01_79_CLE_DET_18,"Bieber, Shane",1533,-4,0,1529,0.64,"Soto, Gregory",1425,-18,24,1431,0.36
649,01_79_PIT_MIA_18,Pitcher TBD,1486,-3,0,1483,0.52,"Lopez, Pablo",1438,5,24,1467,0.48
650,01_79_NYY_CHW_19,"Green, Chad",1564,-24,0,1540,0.57,"Lopez, Reynaldo",1468,-3,24,1489,0.43
651,01_79_TEX_CIN_19,"Minor, Mike",1489,38,0,1527,0.5,"Roark, Tanner",1503,-1,24,1526,0.5
652,01_79_KC_MIN_19,"Sparkman, Glenn",1439,3,0,1442,0.3,"Odorizzi, Jake",1547,22,24,1593,0.7
653,01_79_STL_NYM_19,"Wacha, Michael",1522,-11,0,1511,0.46,"Syndergaard, Noah",1510,8,24,1542,0.54
654,01_79_PHI_ATL_19,"Nola, Aaron",1522,25,0,1547,0.51,"Newcomb, Sean",1522,-7,24,1539,0.49
655,01_79_SD_COL_20,"Lauer, Eric",1478,1,0,1479,0.37,"Marquez, German",1518,30,24,1572,0.63
656,01_79_SEA_OAK_21,"LeBlanc, Wade",1476,3,0,1479,0.39,"Montas, Frankie",1517,13,24,1554,0.61
657,01_79_CHC_LAD_21,"Darvish, Yu",1536,-13,0,1523,0.36,"Buehler, Walker",1582,15,24,1621,0.64
658,01_80_TEX_CIN_13,"Jurado, Ariel",1490,-7,0,1483,0.43,"Gray, Sonny",1502,5,24,1531,0.57
659,01_80_BOS_BAL_13,"Johnson, Brian",1551,-30,0,1521,0.59,"Means, John",1401,33,24,1458,0.41
660,01_80_CLE_DET_13,"Bauer, Trevor",1534,12,0,1546,0.61,"Turnbull, Spencer",1424,22,24,1470,0.39
661,01_80_PIT_MIA_13,"Archer, Chris",1485,-4,0,1481,0.54,"Alcantara, Sandy",1439,-7,24,1456,0.46
662,01_80_STL_NYM_13,"Hudson, Dakota",1521,-1,0,1520,0.49,"Vargas, Jason",1511,-11,24,1524,0.51
663,01_80_LAA_TB_13,"Canning, Griffin",1504,17,0,1521,0.46,"Stanek, Ryne",1545,-20,24,1549,0.54
664,01_80_PHI_ATL_13,Pitcher TBD,1523,0,0,1523,0.47,"Foltynewicz, Mike",1521,2,24,1547,0.53
665,01_80_ARI_WSH_13,"Bradley, Archie",1523,-20,0,1503,0.46,"Sanchez, Anibal",1520,-9,24,1535,0.54
666,01_80_NYY_CHW_14,"Paxton, James",1566,10,0,1576,0.64,"Despaigne, Odrisamer",1466,-17,24,1473,0.36
667,01_80_TOR_HOU_14,"Thornton, Trent",1457,7,0,1464,0.31,"Peacock, Brad",1585,-8,24,1601,0.69
668,01_80_KC_MIN_14,"Junis, Jakob",1439,3,0,1442,0.35,"Perez, Martin",1547,-25,24,1546,0.65
669,01_80_SD_COL_15,"Margevicius, Nick",1479,-21,0,1458,0.39,"Lambert, Peter",1517,-3,24,1538,0.61
670,01_80_MIL_SF_16,"Anderson, Chase",1530,6,0,1536,0.57,"Samardzija, Jeff",1455,6,24,1485,0.43
671,01_80_SEA_OAK_16,"Leake, Mike",1474,14,0,1488,0.43,"Anderson, Tanner",1520,-6,24,1538,0.57
672,01_80_CHC_LAD_19,"Quintana, Jose",1536,-3,0,1533,0.37,"Ryu, Hyun-Jin",1582,17,24,1623,0.63
673,01_81_TB_NYY_19,"Chirinos, Yonny",1546,-1,-3,1542,0.41,"Tanaka, Masahiro",1567,14,21,1602,0.59
674,01_81_PHI_WSH_19,"Arrieta, Jake",1520,-8,-3,1509,0.45,"Corbin, Patrick",1523,0,24,1547,0.55
675,01_81_LAA_TOR_19,"Pena, Felix",1503,11,-3,1511,0.58,"Jackson, Edwin",1463,-28,21,1456,0.42
676,01_81_HOU_CIN_19,"Miley, Wade",1580,-11,-3,1566,0.52,"Castillo, Luis",1504,23,24,1551,0.48
677,01_81_NYM_ATL_19,"Wheeler, Zack",1510,1,-3,1508,0.4,"Soroka, Mike",1525,28,24,1577,0.6
678,01_81_CLE_TEX_20,"Clevinger, Mike",1536,23,-3,1556,0.54,"Lynn, Lance",1488,18,21,1527,0.46
679,01_81_BOS_MIN_20,"Porcello, Rick",1552,-11,-3,1538,0.44,"Berrios, Jose",1546,13,24,1583,0.56
680,01_81_MIA_STL_20,"Hernandez, Elieser",1438,-18,-3,1417,0.31,"Mikolas, Miles",1522,11,21,1554,0.69
681,01_81_SF_LAD_22,"Beede, Tyler",1454,-23,-2,1429,0.28,"Maeda, Kenta",1582,-15,24,1591,0.72
682,01_81_BAL_OAK_22,"Cashner, Andrew",1400,3,-4,1399,0.29,"Fiers, Mike",1518,9,24,1551,0.71
683,01_81_MIL_SD_22,"Chacin, Jhoulys",1531,0,-2,1529,0.53,"Lucchesi, Joey",1480,8,21,1509,0.47
684,01_81_KC_SEA_22,"Duffy, Danny",1441,9,-3,1447,0.43,"Milone, Tommy",1476,-5,21,1492,0.57
685,01_82_TB_NYY_19,"Stanek, Ryne",1545,-20,0,1525,0.41,"Happ, J.A.",1569,-2,24,1591,0.59
686,01_82_DET_PIT_19,"Norris, Daniel",1422,0,0,1422,0.41,"Keller, Mitch",1486,-22,23,1487,0.59
687,01_82_PHI_WSH_19,"Arrieta, Jake",1520,-8,-1,1511,0.45,"Corbin, Patrick",1523,0,26,1549,0.55
688,01_82_LAA_TOR_19,"Skaggs, Tyler",1506,1,0,1507,0.51,"Stroman, Marcus",1461,16,24,1501,0.49
689,01_82_HOU_CIN_19,"Verlander, Justin",1579,41,0,1620,0.64,"DeSclafani, Anthony",1505,-12,24,1517,0.36
690,01_82_NYM_ATL_19,"deGrom, Jacob",1508,39,0,1547,0.46,"Teheran, Julio",1527,21,24,1572,0.54
691,01_82_CHW_CHC_20,"Nova, Ivan",1465,-11,1,1455,0.34,"Hamels, Cole",1536,15,22,1573,0.66
692,01_82_CLE_TEX_20,"Plesac, Zach",1533,-20,0,1513,0.51,"Sampson, Adrian",1490,-7,24,1507,0.49
693,01_82_BOS_MIN_20,"Price, David",1554,12,0,1566,0.51,"Pineda, Michael",1544,-13,24,1555,0.49
694,01_82_MIA_STL_20,"Yamamoto, Jordan",1437,-6,0,1431,0.32,"Flaherty, Jack",1523,14,24,1561,0.68
695,01_82_COL_ARI_21,"Senzatela, Antonio",1516,-16,-1,1499,0.44,"Kelly, Merrill",1520,2,22,1544,0.56
696,01_82_BAL_OAK_22,"Ynoa, Gabriel",1400,2,0,1402,0.31,"Anderson, Brett",1518,-4,24,1538,0.69
697,01_82_SF_LAD_22,"Anderson, Shaun",1454,2,0,1456,0.3,"Kershaw, Clayton",1582,-3,24,1603,0.7
698,01_82_MIL_SD_22,"Woodruff, Brandon",1531,18,0,1549,0.57,"Allen, Logan",1480,-2,24,1502,0.43
699,01_82_KC_SEA_22,"Bailey, Homer",1441,-16,0,1425,0.41,"Kikuchi, Yusei",1476,-9,24,1491,0.59
700,01_83_HOU_CIN_12,"Cole, Gerrit",1577,19,0,1596,0.62,"Mahle, Tyler",1507,-19,24,1512,0.38
701,01_83_TB_NYY_13,"Snell, Blake",1543,21,0,1564,0.48,"Sabathia, CC",1570,-16,24,1578,0.52
702,01_83_PHI_WSH_13,"Eflin, Zach",1520,8,2,1530,0.47,"Corbin, Patrick",1523,0,29,1552,0.53
703,01_83_BAL_OAK_15,"Rogers, Josh",1398,-8,0,1390,0.29,"Bassitt, Chris",1520,2,24,1546,0.71
704,01_83_MIL_SD_15,"Davies, Zach",1528,9,0,1537,0.54,"Strahm, Matt",1484,5,24,1513,0.46
705,01_83_KC_SEA_18,"Keller, Brad",1442,23,0,1465,0.44,"Gonzales, Marco",1474,9,24,1507,0.56
706,01_83_DET_PIT_19,"Zimmermann, Jordan",1423,-10,0,1413,0.33,"Williams, Trevor",1484,30,24,1538,0.67
707,01_83_PHI_WSH_19,"Arrieta, Jake",1520,-8,0,1512,0.45,Pitcher TBD,1523,1,24,1548,0.55
708,01_83_LAA_TOR_19,"Heaney, Andrew",1507,10,0,1517,0.55,"Sanchez, Aaron",1459,-4,24,1479,0.45
709,01_83_NYM_ATL_19,"Matz, Steven",1511,-15,0,1496,0.42,"Fried, Max",1524,2,24,1550,0.58
710,01_83_CHW_CHC_20,"Giolito, Lucas",1467,37,0,1504,0.44,"Lester, Jon",1534,-13,24,1545,0.56
711,01_83_CLE_TEX_20,"Plutko, Adam",1536,-38,0,1498,0.5,"Palumbo, Joe",1487,-12,24,1499,0.5
712,01_83_BOS_MIN_20,"Rodriguez, Eduardo",1554,-5,0,1549,0.47,"Gibson, Kyle",1544,4,24,1572,0.53
713,01_83_MIA_STL_20,"Richards, Trevor",1441,0,0,1441,0.35,"Ponce de Leon, Daniel",1520,5,24,1549,0.65
714,01_83_COL_ARI_21,"Gray, Jon",1519,8,0,1527,0.43,"Greinke, Zack",1517,37,24,1578,0.57
715,01_83_SF_LAD_22,"Pomeranz, Drew",1456,-10,0,1446,0.29,"Hill, Rich",1581,-4,24,1601,0.71
716,01_84_CLE_TEX_14,"Bieber, Shane",1538,-2,0,1536,0.48,"Minor, Mike",1485,39,24,1548,0.52
717,01_84_COL_ARI_15,"Hoffman, Jeff",1521,-18,0,1503,0.43,"Ray, Robbie",1516,10,24,1550,0.57
718,01_84_HOU_NYY_19,"Valdez, Framber",1576,-20,-3,1553,0.47,"Green, Chad",1573,-23,24,1574,0.53
719,01_84_PHI_WSH_19,"Nola, Aaron",1517,19,0,1536,0.46,"Strasburg, Stephen",1526,11,24,1561,0.54
720,01_84_LAA_TOR_19,"Suarez, Jose",1509,-4,0,1505,0.56,"Richard, Clayton",1458,-22,24,1460,0.44
721,01_84_MIA_STL_19,"Gallen, Zac",1440,-18,0,1422,0.34,"Wainwright, Adam",1520,-7,24,1537,0.66
722,01_84_CIN_MIL_20,"Roark, Tanner",1508,-2,-2,1504,0.43,"Nelson, Jimmy",1527,10,20,1557,0.57
723,01_84_NYM_CHC_20,"Lockett, Walker",1509,-43,-3,1463,0.41,"Chatwood, Tyler",1535,-30,24,1529,0.59
724,01_84_MIN_KC_20,"Odorizzi, Jake",1543,18,-2,1559,0.63,"Sparkman, Glenn",1444,1,20,1465,0.37
725,01_84_TB_OAK_22,"Morton, Charlie",1540,23,-4,1559,0.5,"Montas, Frankie",1522,13,24,1559,0.5
726,01_84_SF_LAD_22,"Bumgarner, Madison",1455,27,0,1482,0.36,"Urias, Julio",1582,-25,24,1581,0.64
727,01_84_BAL_SEA_22,"Bundy, Dylan",1397,15,-3,1409,0.37,"LeBlanc, Wade",1472,4,24,1500,0.63
728,01_85_NYM_CHC_14,"Vargas, Jason",1508,-9,0,1499,0.42,"Darvish, Yu",1537,-6,24,1555,0.58
729,01_85_HOU_NYY_19,"Peacock, Brad",1574,-10,0,1564,0.44,"Paxton, James",1575,7,24,1606,0.56
730,01_85_MIA_PHI_19,"Alcantara, Sandy",1442,-10,-3,1429,0.32,"Nola, Aaron",1515,20,22,1557,0.68
731,01_85_SD_PIT_19,"Lauer, Eric",1485,-2,-2,1481,0.46,"Musgrove, Joe",1485,0,26,1511,0.54
732,01_85_ATL_WSH_19,"Keuchel, Dallas",1526,12,-1,1537,0.46,"Strasburg, Stephen",1527,12,24,1563,0.54
733,01_85_TOR_BOS_19,"Thornton, Trent",1459,13,-2,1470,0.29,"Sale, Chris",1555,45,23,1623,0.71
734,01_85_DET_CLE_19,"Boyd, Matthew",1423,29,0,1452,0.33,"Bauer, Trevor",1537,16,21,1574,0.67
735,01_85_LAA_STL_20,"Canning, Griffin",1507,17,-3,1521,0.49,"Wacha, Michael",1519,-16,24,1527,0.51
736,01_85_CHW_TEX_20,"Lopez, Reynaldo",1465,-2,-1,1462,0.45,"Jurado, Ariel",1486,-15,24,1495,0.55
737,01_85_CIN_MIL_20,"Gray, Sonny",1511,2,0,1513,0.44,"Anderson, Chase",1524,6,24,1554,0.56
738,01_85_MIN_KC_20,"Perez, Martin",1541,-23,0,1518,0.56,"Junis, Jakob",1446,2,24,1472,0.44
739,01_85_SF_ARI_21,"Samardzija, Jeff",1453,5,-2,1456,0.42,"Clarke, Taylor",1514,-27,24,1511,0.58
740,01_85_TB_OAK_22,Pitcher TBD,1540,0,0,1540,0.5,"Anderson, Tanner",1522,-5,24,1541,0.5
741,01_85_COL_LAD_22,"Marquez, German",1522,27,-2,1547,0.39,"Buehler, Walker",1583,19,24,1626,0.61
742,01_85_BAL_SEA_22,Pitcher TBD,1397,5,0,1402,0.35,"Leake, Mike",1472,16,24,1512,0.65
743,01_86_MIN_KC_14,"Berrios, Jose",1542,20,0,1562,0.62,"Duffy, Danny",1445,5,24,1474,0.38
744,01_86_LAA_STL_14,"Pena, Felix",1505,12,0,1517,0.47,"Hudson, Dakota",1521,-5,24,1540,0.53
745,01_86_NYM_CHC_14,"Wheeler, Zack",1509,-1,0,1508,0.43,"Quintana, Jose",1535,-4,24,1555,0.57
746,01_86_TOR_BOS_16,Pitcher TBD,1458,0,0,1458,0.37,"Johnson, Brian",1556,-31,24,1549,0.63
747,01_86_MIA_PHI_16,"Hernandez, Elieser",1443,-16,0,1427,0.36,"Velasquez, Vince",1514,-10,24,1528,0.64
748,01_86_SD_PIT_16,"Paddack, Chris",1484,11,0,1495,0.49,"Archer, Chris",1486,-6,24,1504,0.51
749,01_86_TB_OAK_16,"Chirinos, Yonny",1539,1,0,1540,0.48,"Fiers, Mike",1523,9,24,1556,0.52
750,01_86_DET_CLE_16,"Turnbull, Spencer",1422,17,0,1439,0.38,"Civale, Aaron",1538,-34,24,1528,0.62
751,01_86_CIN_MIL_16,"Castillo, Luis",1514,23,0,1537,0.49,"Chacin, Jhoulys",1521,2,24,1547,0.51
752,01_86_BAL_SEA_16,"Cashner, Andrew",1395,6,0,1401,0.37,"Milone, Tommy",1473,-3,24,1494,0.63
753,01_86_COL_LAD_19,"Lambert, Peter",1521,-14,0,1507,0.34,"Ryu, Hyun-Jin",1585,16,24,1625,0.66
754,01_86_HOU_NYY_19,"Miley, Wade",1573,-12,0,1561,0.42,"Tanaka, Masahiro",1577,19,24,1620,0.58
755,01_86_ATL_WSH_19,"Foltynewicz, Mike",1525,5,0,1530,0.48,"Sanchez, Anibal",1528,-9,24,1543,0.52
756,01_86_CHW_TEX_21,"Despaigne, Odrisamer",1466,-20,0,1446,0.38,"Lynn, Lance",1485,23,24,1532,0.62
757,01_86_SF_ARI_22,"Beede, Tyler",1455,-14,0,1441,0.4,"Godley, Zack",1511,-24,24,1511,0.6
758,01_87_DET_CLE_13,"Norris, Daniel",1421,2,0,1423,0.33,"Plesac, Zach",1539,-14,24,1549,0.67
759,01_87_TOR_BOS_13,"Stroman, Marcus",1460,19,0,1479,0.37,"Porcello, Rick",1554,-6,24,1572,0.63
760,01_87_MIA_PHI_13,"Yamamoto, Jordan",1445,3,0,1448,0.4,"De Los Santos, Enyel",1512,-21,24,1515,0.6
761,01_87_SD_PIT_13,"Lucchesi, Joey",1482,11,0,1493,0.48,"Brault, Steven",1488,-7,24,1505,0.52
762,01_87_ATL_WSH_13,"Soroka, Mike",1527,29,0,1556,0.5,"Corbin, Patrick",1526,2,24,1552,0.5
763,01_87_HOU_NYY_14,"Verlander, Justin",1572,38,0,1610,0.52,"Happ, J.A.",1578,-3,24,1599,0.48
764,01_87_CIN_MIL_14,"DeSclafani, Anthony",1512,-9,0,1503,0.41,"Woodruff, Brandon",1522,19,24,1565,0.59
765,01_87_MIN_KC_14,"Pineda, Michael",1542,-7,0,1535,0.61,"Bailey, Homer",1444,-10,24,1458,0.39
766,01_87_NYM_CHC_14,"deGrom, Jacob",1512,42,0,1554,0.47,"Hamels, Cole",1532,20,24,1576,0.53
767,01_87_CHW_TEX_15,"Nova, Ivan",1466,-8,0,1458,0.44,"Sampson, Adrian",1486,-11,24,1499,0.56
768,01_87_TB_OAK_16,"Stanek, Ryne",1539,-18,0,1521,0.47,"Anderson, Brett",1522,-4,24,1542,0.53
769,01_87_SF_ARI_16,"Anderson, Shaun",1455,2,0,1457,0.39,"Kelly, Merrill",1511,1,24,1536,0.61
770,01_87_COL_LAD_16,"Senzatela, Antonio",1521,-15,0,1506,0.38,"Maeda, Kenta",1586,-17,24,1593,0.62
771,01_87_BAL_SEA_16,"Ynoa, Gabriel",1397,-4,0,1393,0.37,"Kikuchi, Yusei",1471,-13,24,1482,0.63
772,01_87_LAA_STL_19,"Skaggs, Tyler",1504,7,0,1511,0.44,"Mikolas, Miles",1522,10,24,1556,0.56
773,01_88_TOR_NYY_19,"Sanchez, Aaron",1463,-11,-2,1450,0.31,"Sabathia, CC",1576,-11,24,1589,0.69
774,01_88_NYM_PHI_19,"Matz, Steven",1511,-19,-3,1489,0.42,"Eflin, Zach",1510,9,24,1543,0.58
775,01_88_CHW_BOS_19,"Giolito, Lucas",1464,32,-4,1492,0.39,"Rodriguez, Eduardo",1551,-5,24,1570,0.61
776,01_88_KC_CLE_19,"Keller, Brad",1447,13,-3,1457,0.4,"Plutko, Adam",1540,-37,24,1527,0.6
777,01_88_ATL_CHC_20,"Teheran, Julio",1528,16,-3,1541,0.49,"Lester, Jon",1533,-11,24,1546,0.51
778,01_88_LAD_ARI_21,"Kershaw, Clayton",1587,0,-2,1585,0.52,"Greinke, Zack",1510,36,24,1570,0.48
779,01_88_COL_SF_22,"Gray, Jon",1520,8,-2,1526,0.59,"Pomeranz, Drew",1457,-14,21,1464,0.41
780,01_89_TEX_DET_19,"Chavez, Jesse",1487,-14,-1,1472,0.55,"Zimmermann, Jordan",1420,-9,25,1436,0.45
781,01_89_SD_BAL_19,"Allen, Logan",1481,6,0,1487,0.58,"Yacabonis, Jimmy",1395,16,22,1433,0.42
782,01_89_TOR_NYY_19,"Richard, Clayton",1462,-22,0,1440,0.29,Pitcher TBD,1576,-1,24,1599,0.71
783,01_89_NYM_PHI_19,"Lockett, Walker",1509,-46,0,1463,0.4,"Arrieta, Jake",1512,-3,24,1533,0.6
784,01_89_CHW_BOS_19,Pitcher TBD,1463,-2,0,1461,0.32,"Price, David",1552,15,24,1591,0.68
785,01_89_KC_CLE_19,"Sparkman, Glenn",1446,6,0,1452,0.34,"Bieber, Shane",1541,2,24,1567,0.66
786,01_89_WSH_MIA_19,"Scherzer, Max",1525,44,-1,1568,0.64,"Richards, Trevor",1447,1,23,1471,0.36
787,01_89_ATL_CHC_20,"Fried, Max",1526,6,0,1532,0.5,"Alzolay, Adbert",1535,-25,24,1534,0.5
788,01_89_PIT_HOU_20,"Williams, Trevor",1489,23,-1,1511,0.36,"Cole, Gerrit",1574,18,23,1615,0.64
789,01_89_SEA_MIL_20,"Gonzales, Marco",1474,14,-2,1486,0.4,"Davies, Zach",1524,4,26,1554,0.6
790,01_89_TB_MIN_20,"Snell, Blake",1542,14,-2,1554,0.48,"Gibson, Kyle",1540,1,24,1565,0.52
791,01_89_OAK_STL_20,"Bassitt, Chris",1520,5,-2,1523,0.45,"Flaherty, Jack",1520,11,26,1557,0.55
792,01_89_LAD_ARI_21,"Stripling, Ross",1585,-17,0,1568,0.53,"Ray, Robbie",1512,11,24,1547,0.47
793,01_89_COL_SF_21,"Gonzalez, Chi Chi",1521,-30,0,1491,0.48,"Bumgarner, Madison",1456,21,24,1501,0.52
794,01_89_CIN_LAA_22,"Mahle, Tyler",1511,-13,-2,1496,0.45,"Heaney, Andrew",1506,5,22,1533,0.55
795,01_90_CHW_BOS_13,"Lopez, Reynaldo",1463,-1,0,1462,0.29,"Sale, Chris",1553,42,24,1619,0.71
796,01_90_TOR_NYY_13,"Thornton, Trent",1461,16,0,1477,0.32,"Paxton, James",1577,10,24,1611,0.68
797,01_90_KC_CLE_13,"Junis, Jakob",1448,3,0,1451,0.33,"Bauer, Trevor",1539,8,24,1571,0.67
798,01_90_SD_BAL_15,"Strahm, Matt",1483,2,0,1485,0.57,"Bundy, Dylan",1393,17,24,1434,0.43
799,01_90_LAD_ARI_15,"Gonsolin, Tony",1586,-37,0,1549,0.57,"Clarke, Taylor",1511,-36,24,1499,0.43
800,01_90_COL_SF_15,"Marquez, German",1519,29,0,1548,0.59,"Samardzija, Jeff",1457,4,24,1485,0.41
801,01_90_NYM_PHI_19,"Vargas, Jason",1508,-9,0,1499,0.46,"Pivetta, Nick",1513,-8,24,1529,0.54
802,01_90_TEX_DET_19,"Minor, Mike",1488,40,0,1528,0.59,"Boyd, Matthew",1419,25,24,1468,0.41
803,01_90_WSH_MIA_19,"Corbin, Patrick",1527,1,0,1528,0.6,"Gallen, Zac",1445,-14,24,1455,0.4
804,01_90_OAK_STL_19,"Mengden, Daniel",1522,-6,0,1516,0.47,"Wainwright, Adam",1518,-7,24,1535,0.53
805,01_90_SEA_MIL_20,Pitcher TBD,1477,3,0,1480,0.42,"Houser, Adrian",1521,-11,24,1534,0.58
806,01_90_ATL_CHC_20,"Keuchel, Dallas",1527,11,0,1538,0.48,"Darvish, Yu",1534,-5,24,1553,0.52
807,01_90_CIN_LAA_20,"Roark, Tanner",1511,4,0,1515,0.47,Pitcher TBD,1506,4,24,1534,0.53
808,01_90_PIT_HOU_20,Pitcher TBD,1487,1,0,1488,0.38,"Valdez, Framber",1575,-27,24,1572,0.62
809,01_90_TB_MIN_20,"Morton, Charlie",1540,25,0,1565,0.48,"Odorizzi, Jake",1542,15,24,1581,0.52
810,01_91_NYM_PHI_13,"Wheeler, Zack",1507,4,0,1511,0.43,"Nola, Aaron",1514,25,24,1563,0.57
811,01_91_TEX_DET_13,"Jurado, Ariel",1490,-17,0,1473,0.52,"Turnbull, Spencer",1418,17,24,1459,0.48
812,01_91_TB_MIN_13,"Stanek, Ryne",1539,-17,0,1522,0.47,"Perez, Martin",1543,-26,24,1541,0.53
813,01_91_PIT_HOU_14,"Musgrove, Joe",1493,4,0,1497,0.37,"Peacock, Brad",1570,-6,24,1588,0.63
814,01_91_SEA_MIL_14,"Leake, Mike",1478,11,0,1489,0.42,"Anderson, Chase",1519,6,24,1549,0.58
815,01_91_ATL_CHC_14,"Wilson, Bryse",1528,-8,0,1520,0.49,"Chatwood, Tyler",1533,-29,24,1528,0.51
816,01_91_WSH_MIA_19,"Strasburg, Stephen",1528,9,0,1537,0.61,"Alcantara, Sandy",1444,-7,24,1461,0.39
817,01_91_LAD_COL_20,"Buehler, Walker",1583,24,-3,1604,0.61,"Lambert, Peter",1521,-16,21,1526,0.39
818,01_91_ARI_SF_21,"Young, Alex",1514,-18,-3,1493,0.54,"Beede, Tyler",1456,-17,24,1463,0.46
819,01_91_OAK_LAA_22,"Anderson, Tanner",1523,-7,-4,1512,0.45,"Canning, Griffin",1509,14,24,1547,0.55
820,01_92_CLE_BAL_19,"Clevinger, Mike",1539,19,0,1558,0.65,"Means, John",1392,35,26,1453,0.35
821,01_92_KC_TOR_19,"Duffy, Danny",1447,6,0,1453,0.46,Pitcher TBD,1461,0,24,1485,0.54
822,01_92_CHC_CIN_19,"Hamels, Cole",1534,20,-2,1552,0.53,"Gray, Sonny",1508,0,22,1530,0.47
823,01_92_WSH_DET_19,"Sanchez, Anibal",1529,-11,-3,1515,0.6,"Norris, Daniel",1416,3,24,1443,0.4
824,01_92_PHI_MIA_19,"Velasquez, Vince",1515,-5,-3,1507,0.58,"Hernandez, Elieser",1443,-15,24,1452,0.42
825,01_92_ATL_NYM_19,"Soroka, Mike",1527,30,-3,1554,0.48,"deGrom, Jacob",1506,43,23,1572,0.52
826,01_92_TEX_TB_19,"Lynn, Lance",1491,19,-3,1507,0.42,"Chirinos, Yonny",1540,3,21,1564,0.58
827,01_92_PIT_MIL_20,"Archer, Chris",1497,-5,-3,1489,0.42,"Chacin, Jhoulys",1520,-1,24,1543,0.58
828,01_92_MIN_CHW_20,"Berrios, Jose",1541,20,-2,1559,0.6,Pitcher TBD,1464,-2,23,1485,0.4
829,01_92_SEA_HOU_20,Pitcher TBD,1477,3,-3,1477,0.36,"Miley, Wade",1565,-9,24,1580,0.64
830,01_92_LAD_COL_20,"Ryu, Hyun-Jin",1585,18,0,1603,0.6,"Senzatela, Antonio",1519,-10,24,1533,0.4
831,01_92_OAK_LAA_22,"Fiers, Mike",1521,13,0,1534,0.48,"Pena, Felix",1511,10,24,1545,0.52
832,01_92_STL_SD_22,"Wacha, Michael",1517,-13,-2,1502,0.49,"Lauer, Eric",1485,0,22,1507,0.51
833,01_92_ARI_SF_22,"Kelly, Merrill",1515,3,0,1518,0.55,"Anderson, Shaun",1454,6,24,1484,0.45
834,01_93_NYY_BOS_13,"Tanaka, Masahiro",1577,22,3,1602,0.58,"Porcello, Rick",1551,-8,5,1548,0.42
835,01_93_CLE_BAL_16,"Plesac, Zach",1534,-10,0,1524,0.63,"Cashner, Andrew",1397,11,24,1432,0.37
836,01_93_KC_TOR_16,"Bailey, Homer",1446,-6,0,1440,0.4,"Stroman, Marcus",1463,24,24,1511,0.6
837,01_93_CHC_CIN_16,"Quintana, Jose",1532,-11,0,1521,0.46,"Castillo, Luis",1510,18,24,1552,0.54
838,01_93_WSH_DET_16,"Voth, Austin",1530,-32,0,1498,0.6,"Soto, Gregory",1415,-13,24,1426,0.4
839,01_93_PHI_MIA_16,"Eflin, Zach",1513,4,0,1517,0.56,"Yamamoto, Jordan",1445,6,24,1475,0.44
840,01_93_ATL_NYM_16,"Teheran, Julio",1529,10,0,1539,0.55,"Matz, Steven",1504,-27,24,1501,0.45
841,01_93_TEX_TB_16,"Sampson, Adrian",1493,-10,0,1483,0.43,"McKay, Brendan",1538,-28,24,1534,0.57
842,01_93_MIN_CHW_16,"Pineda, Michael",1540,-10,0,1530,0.57,"Nova, Ivan",1466,-9,24,1481,0.43
843,01_93_LAD_COL_20,"Kershaw, Clayton",1582,1,0,1583,0.54,"Gray, Jon",1522,13,24,1559,0.46
844,01_93_SEA_HOU_20,"Kikuchi, Yusei",1476,-14,0,1462,0.27,"Verlander, Justin",1566,42,24,1632,0.73
845,01_93_PIT_MIL_20,"Lyles, Jordan",1498,-5,0,1493,0.4,"Woodruff, Brandon",1519,21,24,1564,0.6
846,01_93_ARI_SF_22,"Greinke, Zack",1515,34,0,1549,0.62,"Pomeranz, Drew",1454,-12,24,1466,0.38
847,01_93_OAK_LAA_22,"Anderson, Brett",1521,-10,0,1511,0.46,"Skaggs, Tyler",1511,8,24,1543,0.54
848,01_93_STL_SD_22,"Hudson, Dakota",1517,1,0,1518,0.5,"Paddack, Chris",1485,8,24,1517,0.5
849,01_94_NYY_BOS_10,"Tarpley, Stephen",1579,-21,0,1558,0.52,"Rodriguez, Eduardo",1550,-6,0,1544,0.48
850,01_94_CLE_BAL_13,"Bieber, Shane",1529,4,0,1533,0.67,"Ynoa, Gabriel",1402,-15,24,1411,0.33
851,01_94_KC_TOR_13,"Keller, Brad",1445,16,0,1461,0.48,"Sanchez, Aaron",1464,-12,24,1476,0.52
852,01_94_CHC_CIN_13,"Lester, Jon",1535,-7,0,1528,0.51,"DeSclafani, Anthony",1507,-12,24,1519,0.49
853,01_94_WSH_DET_13,"Scherzer, Max",1528,46,0,1574,0.69,"Zimmermann, Jordan",1417,-10,24,1431,0.31
854,01_94_PHI_MIA_13,"Arrieta, Jake",1511,-6,0,1505,0.55,"Richards, Trevor",1447,-2,24,1469,0.45
855,01_94_TEX_TB_13,"Chavez, Jesse",1492,-13,0,1479,0.37,"Snell, Blake",1539,6,24,1569,0.63
856,01_94_MIN_CHW_14,"Thorpe, Lewis",1542,-25,0,1517,0.5,"Giolito, Lucas",1464,30,24,1518,0.5
857,01_94_SEA_HOU_14,"Gonzales, Marco",1476,13,0,1489,0.33,"Cole, Gerrit",1567,21,24,1612,0.67
858,01_94_PIT_MIL_14,"Brault, Steven",1497,-9,0,1488,0.42,"Davies, Zach",1520,-1,24,1543,0.58
859,01_94_LAD_COL_15,"Maeda, Kenta",1581,-12,0,1569,0.57,"Gonzalez, Chi Chi",1523,-30,24,1517,0.43
860,01_94_ARI_SF_16,"Ray, Robbie",1513,12,0,1525,0.53,"Bumgarner, Madison",1456,23,24,1503,0.47
861,01_94_OAK_LAA_16,"Bassitt, Chris",1526,1,0,1527,0.49,"Heaney, Andrew",1507,4,24,1535,0.51
862,01_94_STL_SD_16,"Mikolas, Miles",1515,11,0,1526,0.51,"Lucchesi, Joey",1486,10,24,1520,0.49
863,01_94_ATL_NYM_19,"Fried, Max",1530,9,0,1539,0.51,"Syndergaard, Noah",1503,9,24,1536,0.49
864,01_95_KC_TOR_13,"Sparkman, Glenn",1446,1,0,1447,0.47,"Richard, Clayton",1463,-20,24,1467,0.53
865,01_95_CHC_PIT_19,"Alzolay, Adbert",1534,-20,-2,1512,0.46,"Williams, Trevor",1496,20,22,1538,0.54
866,01_95_MIL_CIN_19,"Houser, Adrian",1521,-16,-2,1503,0.48,"Mahle, Tyler",1508,-17,24,1515,0.52
867,01_95_BAL_TB_19,"Eshelman, Thomas",1402,4,-3,1403,0.3,"Stanek, Ryne",1540,-18,24,1546,0.7
868,01_95_LAA_TEX_20,"Suarez, Jose",1503,-14,-3,1486,0.41,"Minor, Mike",1491,39,21,1551,0.59
869,01_95_SF_SD_22,"Samardzija, Jeff",1458,0,-2,1456,0.41,"Allen, Logan",1488,6,24,1518,0.59
870,01_96_CHC_PIT_19,"Hendricks, Kyle",1530,20,0,1550,0.53,"Musgrove, Joe",1500,6,24,1530,0.47
871,01_96_MIA_WSH_19,"Gallen, Zac",1445,-9,-1,1435,0.33,"Corbin, Patrick",1529,4,24,1557,0.67
872,01_96_BOS_TOR_19,"Price, David",1548,16,0,1564,0.59,"Thornton, Trent",1465,12,24,1501,0.41
873,01_96_MIL_CIN_19,"Anderson, Chase",1522,7,0,1529,0.49,"Roark, Tanner",1507,4,24,1535,0.51
874,01_96_NYY_NYM_19,"Paxton, James",1581,5,0,1586,0.57,"Wheeler, Zack",1505,7,26,1538,0.43
875,01_96_BAL_TB_19,"Wojciechowski, Asher",1401,-21,0,1380,0.23,"Morton, Charlie",1541,23,24,1588,0.77
876,01_96_PHI_ATL_19,"Nola, Aaron",1513,33,-1,1545,0.48,"Keuchel, Dallas",1528,9,23,1560,0.52
877,01_96_LAA_TEX_20,"Suarez, Jose",1503,-14,-1,1488,0.41,"Minor, Mike",1491,39,23,1553,0.59
878,01_96_DET_CHW_20,"Boyd, Matthew",1416,24,0,1440,0.43,"Lopez, Reynaldo",1465,-3,26,1488,0.57
879,01_96_HOU_COL_20,"Urquidy, Jose",1568,-35,-1,1532,0.44,"Marquez, German",1521,25,26,1572,0.56
880,01_96_CLE_KC_20,"Bauer, Trevor",1529,14,-1,1542,0.6,"Junis, Jakob",1443,5,21,1469,0.4
881,01_96_MIN_OAK_22,"Odorizzi, Jake",1541,13,-2,1552,0.5,"Mengden, Daniel",1529,-3,24,1550,0.5
882,01_96_ARI_LAD_22,"Clarke, Taylor",1511,-31,0,1480,0.34,"Stripling, Ross",1583,-14,23,1592,0.66
883,01_96_SF_SD_22,"Beede, Tyler",1458,-17,0,1441,0.4,"Strahm, Matt",1488,2,24,1514,0.6
884,01_96_STL_SEA_22,"Flaherty, Jack",1513,7,-1,1519,0.52,"Carasiti, Matt",1475,9,22,1506,0.48
885,01_97_DET_CHW_14,"Norris, Daniel",1416,3,3,1422,0.4,"Cease, Dylan",1465,-3,29,1491,0.6
886,01_97_MIA_WSH_18,"Alcantara, Sandy",1444,-10,0,1434,0.33,"Strasburg, Stephen",1530,7,24,1561,0.67
887,01_97_NYY_NYM_19,"German, Domingo",1579,-8,0,1571,0.57,"Vargas, Jason",1506,-6,24,1524,0.43
888,01_97_CHC_PIT_19,"Darvish, Yu",1528,-5,0,1523,0.5,"Archer, Chris",1502,-4,24,1522,0.5
889,01_97_BOS_TOR_19,"Sale, Chris",1549,40,0,1589,0.64,"Waguespack, Jacob",1464,2,24,1490,0.36
890,01_97_MIL_CIN_19,"Chacin, Jhoulys",1521,-2,0,1519,0.48,"Gray, Sonny",1508,1,24,1533,0.52
891,01_97_BAL_TB_19,"Means, John",1400,39,0,1439,0.35,"Stanek, Ryne",1542,-19,24,1547,0.65
892,01_97_PHI_ATL_19,"Pivetta, Nick",1515,-12,0,1503,0.45,"Wilson, Bryse",1527,-11,24,1540,0.55
893,01_97_LAA_TEX_20,"Canning, Griffin",1506,17,0,1523,0.54,"Jurado, Ariel",1488,-15,24,1497,0.46
894,01_97_DET_CHW_20,"Alexander, Tyler",1416,-2,0,1414,0.41,"Detwiler, Ross",1465,-7,24,1482,0.59
895,01_97_HOU_COL_20,"Miley, Wade",1569,-7,0,1562,0.56,"Lambert, Peter",1520,-22,24,1522,0.44
896,01_97_CLE_KC_20,"Clevinger, Mike",1531,11,0,1542,0.59,"Duffy, Danny",1442,11,24,1477,0.41
897,01_97_MIN_OAK_21,"Gibson, Kyle",1541,1,0,1542,0.46,"Fiers, Mike",1529,14,24,1567,0.54
898,01_97_SF_SD_21,"Anderson, Shaun",1462,4,0,1466,0.45,"Quantrill, Cal",1484,-5,24,1503,0.55
899,01_97_ARI_LAD_22,"Kelly, Merrill",1511,0,0,1511,0.34,"Buehler, Walker",1583,20,24,1627,0.66
900,01_97_STL_SEA_22,"Wainwright, Adam",1513,-3,0,1510,0.5,"Leake, Mike",1475,10,24,1509,0.5
901,01_98_MIA_WSH_11,"Hernandez, Elieser",1443,-11,0,1432,0.35,"Sanchez, Anibal",1530,-12,24,1542,0.65
902,01_98_CLE_KC_13,"Plesac, Zach",1532,-23,0,1509,0.57,"Bailey, Homer",1440,-5,24,1459,0.43
903,01_98_DET_CHW_14,"Boyd, Matthew",1414,25,0,1439,0.43,"Lopez, Reynaldo",1467,-2,24,1489,0.57
904,01_98_MIL_CIN_14,"Woodruff, Brandon",1520,24,0,1544,0.49,"Castillo, Luis",1510,17,24,1551,0.51
905,01_98_CHC_PIT_16,"Quintana, Jose",1527,-5,0,1522,0.5,"Lyles, Jordan",1503,-3,24,1524,0.5
906,01_98_MIN_OAK_16,"Berrios, Jose",1539,17,0,1556,0.53,"Anderson, Tanner",1530,-20,24,1534,0.47
907,01_98_STL_SEA_16,"Wacha, Michael",1512,-10,0,1502,0.5,Pitcher TBD,1476,3,24,1503,0.5
908,01_98_NYY_TB_17,"Happ, J.A.",1581,-7,-3,1571,0.51,"Chirinos, Yonny",1539,-1,24,1562,0.49
909,01_98_PHI_ATL_19,"Eflin, Zach",1512,2,0,1514,0.4,"Soroka, Mike",1529,30,24,1583,0.6
910,01_98_BOS_TOR_19,"Porcello, Rick",1547,-13,0,1534,0.53,"Stroman, Marcus",1466,25,24,1515,0.47
911,01_98_LAA_TEX_20,"Canning, Griffin",1508,16,0,1524,0.48,"Lynn, Lance",1486,24,24,1534,0.52
912,01_98_SD_LAD_21,"Lamet, Dinelson",1479,12,-1,1490,0.32,"Ryu, Hyun-Jin",1584,11,24,1619,0.68
913,01_99_MIL_PIT_19,"Davies, Zach",1519,-1,-2,1516,0.5,"Brault, Steven",1500,-6,24,1518,0.5
914,01_99_KC_WSH_19,"Keller, Brad",1439,13,-3,1449,0.4,"Voth, Austin",1531,-36,24,1519,0.6
915,01_99_BAL_TOR_19,"Bundy, Dylan",1403,9,-1,1411,0.41,"Sanchez, Aaron",1465,-15,24,1474,0.59
916,01_99_BOS_DET_19,"Rodriguez, Eduardo",1548,-2,-2,1544,0.66,"Soto, Gregory",1417,-13,22,1426,0.34
917,01_99_PHI_NYM_19,"Velasquez, Vince",1511,-6,-3,1502,0.4,"deGrom, Jacob",1505,41,26,1572,0.6
918,01_99_NYY_TB_19,"Tanaka, Masahiro",1583,15,0,1598,0.58,"McKay, Brendan",1537,-21,24,1540,0.42
919,01_99_MIA_ATL_19,"Yamamoto, Jordan",1442,3,-3,1442,0.33,"Teheran, Julio",1531,7,24,1562,0.67
920,01_99_LAA_HOU_20,"Pena, Felix",1506,10,-2,1514,0.34,"Verlander, Justin",1570,35,23,1628,0.66
921,01_99_TEX_MIN_20,"Sampson, Adrian",1489,-10,-3,1476,0.41,"Perez, Martin",1538,-19,20,1539,0.59
922,01_99_COL_ARI_21,"Senzatela, Antonio",1519,-13,-1,1505,0.41,"Greinke, Zack",1510,38,24,1572,0.59
923,01_99_SD_LAD_22,"Lauer, Eric",1478,2,0,1480,0.32,"Kershaw, Clayton",1585,2,24,1611,0.68
924,01_99_OAK_SEA_22,"Anderson, Brett",1532,-5,-3,1524,0.56,"Kikuchi, Yusei",1473,-15,24,1482,0.44
925,01_99_STL_SF_22,"Hudson, Dakota",1515,-7,-3,1505,0.54,"Pomeranz, Drew",1467,-11,24,1480,0.46
926,01_100_TEX_MIN_14,"Chavez, Jesse",1486,-11,0,1475,0.38,"Pineda, Michael",1540,-4,24,1560,0.62
927,01_100_BAL_TOR_15,"Cashner, Andrew",1405,14,0,1419,0.43,"Richard, Clayton",1463,-16,24,1471,0.57
928,01_100_MIL_PIT_16,"Houser, Adrian",1520,-20,0,1500,0.47,"Agrazal, Dario",1499,-4,24,1519,0.53
929,01_100_KC_WSH_16,"Sparkman, Glenn",1441,-13,0,1428,0.27,"Scherzer, Max",1529,47,24,1600,0.73
930,01_100_MIA_ATL_16,"Smith, Caleb",1442,6,0,1448,0.34,"Fried, Max",1532,8,24,1564,0.66
931,01_100_CLE_CIN_16,"Bieber, Shane",1534,11,-1,1544,0.53,"DeSclafani, Anthony",1511,-12,26,1525,0.47
932,01_100_BOS_DET_16,"Porcello, Rick",1549,-13,0,1536,0.64,"Zimmermann, Jordan",1416,-5,24,1435,0.36
933,01_100_NYY_TB_16,"Sabathia, CC",1584,-5,0,1579,0.52,"Snell, Blake",1536,8,24,1568,0.48
934,01_100_CHC_CHW_19,"Lester, Jon",1530,-5,0,1525,0.5,"Giolito, Lucas",1464,35,26,1525,0.5
935,01_100_LAA_HOU_19,"Heaney, Andrew",1507,4,0,1511,0.35,"Cole, Gerrit",1568,23,24,1615,0.65
936,01_100_PHI_NYM_19,"Arrieta, Jake",1513,-6,0,1507,0.46,"Syndergaard, Noah",1502,6,24,1532,0.54
937,01_100_STL_SF_22,"Mikolas, Miles",1515,13,0,1528,0.52,"Bumgarner, Madison",1467,25,24,1516,0.48
938,01_100_COL_ARI_22,"Gray, Jon",1517,16,0,1533,0.49,"Ray, Robbie",1512,6,24,1542,0.51
939,01_100_SD_LAD_22,"Paddack, Chris",1478,15,0,1493,0.35,"Maeda, Kenta",1585,-10,24,1599,0.65
940,01_100_OAK_SEA_22,"Bassitt, Chris",1532,2,0,1534,0.54,"Gonzales, Marco",1473,11,24,1508,0.46
941,01_101_BAL_TOR_13,"Ynoa, Gabriel",1408,-13,0,1395,0.37,"Thornton, Trent",1460,5,24,1489,0.63
942,01_101_CLE_CIN_13,"Bauer, Trevor",1536,8,0,1544,0.54,"Mahle, Tyler",1509,-18,24,1515,0.46
943,01_101_BOS_DET_13,"Price, David",1550,20,0,1570,0.69,"Soto, Gregory",1415,-12,24,1427,0.31
944,01_101_PHI_NYM_13,"Nola, Aaron",1512,39,0,1551,0.52,"Wheeler, Zack",1503,11,24,1538,0.48
945,01_101_NYY_TB_13,"Paxton, James",1583,4,0,1587,0.5,"Morton, Charlie",1537,25,24,1586,0.5
946,01_101_MIA_ATL_13,"Richards, Trevor",1443,-4,0,1439,0.33,"Keuchel, Dallas",1530,12,24,1566,0.67
947,01_101_MIL_PIT_13,"Anderson, Chase",1517,7,0,1524,0.48,"Musgrove, Joe",1502,10,24,1536,0.52
948,01_101_KC_WSH_13,"Junis, Jakob",1440,3,0,1443,0.34,"Corbin, Patrick",1530,4,24,1558,0.66
949,01_101_CHC_CHW_14,"Hendricks, Kyle",1532,18,0,1550,0.6,"Nova, Ivan",1463,-8,24,1479,0.4
950,01_101_LAA_HOU_14,"Suarez, Jose",1506,-12,0,1494,0.41,"Urquidy, Jose",1570,-34,24,1560,0.59
951,01_101_TEX_MIN_14,"Leclerc, Jose",1485,-11,0,1474,0.37,"Gibson, Kyle",1542,1,24,1567,0.63
952,01_101_STL_SF_16,"Flaherty, Jack",1517,6,0,1523,0.54,"Samardzija, Jeff",1465,5,24,1494,0.46
953,01_101_COL_ARI_16,"Marquez, German",1517,26,0,1543,0.53,"Young, Alex",1512,-15,24,1521,0.47
954,01_101_SD_LAD_16,"Lucchesi, Joey",1479,12,0,1491,0.36,"Stripling, Ross",1584,-18,24,1590,0.64
955,01_101_OAK_SEA_16,"Mengden, Daniel",1531,-4,0,1527,0.54,Pitcher TBD,1473,2,24,1499,0.46
956,01_115_BOS_BAL_13,"Cashner, Andrew",1545,-13,0,1532,0.66,"Wojciechowski, Asher",1406,-15,24,1415,0.34
957,01_115_COL_NYY_13,"Marquez, German",1499,17,0,1516,0.36,"Paxton, James",1588,4,24,1616,0.64
958,01_115_STL_CIN_13,"Flaherty, Jack",1519,12,0,1531,0.52,"DeSclafani, Anthony",1505,-10,24,1519,0.48
959,01_115_KC_CLE_13,"Sparkman, Glenn",1447,-4,0,1443,0.37,"Plesac, Zach",1540,-25,24,1539,0.63
960,01_115_TOR_DET_13,"Waguespack, Jacob",1466,0,0,1466,0.55,"Alexander, Tyler",1406,5,24,1435,0.45
961,01_115_CHW_TB_13,"Cease, Dylan",1458,-5,0,1453,0.34,"Snell, Blake",1534,9,24,1567,0.66
962,01_115_PHI_PIT_13,"Smyly, Drew",1510,-10,0,1500,0.47,"Agrazal, Dario",1497,-1,24,1520,0.53
963,01_115_TEX_HOU_14,"Lynn, Lance",1479,33,0,1512,0.43,"Armenteros, Rogelio",1572,-35,24,1561,0.57
964,01_115_OAK_MIN_14,"Mengden, Daniel",1542,-3,0,1539,0.47,"Pineda, Michael",1536,-1,24,1559,0.53
965,01_115_SD_CHC_14,"Morejon, Adrian",1475,-2,0,1473,0.36,"Hendricks, Kyle",1537,15,24,1576,0.64
966,01_115_NYM_SF_16,"Matz, Steven",1507,-26,0,1481,0.47,"Menez, Conner",1483,-6,24,1501,0.53
967,01_115_MIL_ARI_16,"Woodruff, Brandon",1518,27,0,1545,0.51,"Young, Alex",1517,-2,24,1539,0.49
968,01_115_MIA_LAD_16,"Yamamoto, Jordan",1443,11,0,1454,0.27,"Buehler, Walker",1586,13,24,1623,0.73
969,01_115_LAA_SEA_16,"Peters, Dillon",1510,-17,0,1493,0.52,"Kikuchi, Yusei",1463,-10,24,1477,0.48
970,01_115_WSH_ATL_19,"Ross, Joe",1536,-34,0,1502,0.44,"Gausman, Kevin",1528,-9,24,1543,0.56
971,01_116_BOS_TB_19,"Rodriguez, Eduardo",1542,8,-3,1547,0.54,"Beeks, Jalen",1535,-40,24,1519,0.46
972,01_116_STL_PIT_19,"Ponce de Leon, Daniel",1520,10,-2,1528,0.5,"Williams, Trevor",1495,8,24,1527,0.5
973,01_116_COL_WSH_19,"Lambert, Peter",1501,-9,-2,1490,0.47,"Fedde, Erick",1534,-41,21,1514,0.53
974,01_116_CLE_TOR_19,"Clevinger, Mike",1541,16,-2,1555,0.57,"Borucki, Ryan",1465,17,22,1504,0.43
975,01_116_MIA_CHW_20,"Richards, Trevor",1442,-7,-4,1431,0.45,"Nova, Ivan",1457,-9,21,1469,0.55
976,01_116_OAK_HOU_20,"Bailey, Homer",1541,-13,-3,1525,0.36,"Cole, Gerrit",1574,28,24,1626,0.64
977,01_116_CIN_MIL_20,"Gray, Sonny",1503,15,-2,1516,0.45,"Anderson, Chase",1519,12,20,1551,0.55
978,01_116_NYY_MIN_20,"Sabathia, CC",1586,-4,-3,1579,0.55,"Perez, Martin",1537,-18,24,1543,0.45
979,01_116_BAL_ARI_21,"Brooks, Aaron",1409,3,-4,1408,0.31,"Ray, Robbie",1516,8,24,1548,0.69
980,01_116_CHC_SF_21,"Mills, Alec",1534,-15,-4,1515,0.53,"Anderson, Shaun",1484,-13,24,1495,0.47
981,01_116_TEX_SEA_22,"Sampson, Adrian",1478,-13,-4,1461,0.44,"Gonzales, Marco",1460,15,24,1499,0.56
982,01_117_STL_PIT_19,"Hudson, Dakota",1521,-10,0,1511,0.49,"Archer, Chris",1494,2,24,1520,0.51
983,01_117_COL_WSH_19,"Lambert, Peter",1501,-9,0,1492,0.39,"Strasburg, Stephen",1534,11,23,1568,0.61
984,01_117_CLE_TOR_19,"Bauer, Trevor",1542,8,0,1550,0.61,"Sanchez, Aaron",1463,-13,24,1474,0.39
985,01_117_PHI_DET_19,"Nola, Aaron",1511,36,0,1547,0.62,"Boyd, Matthew",1407,27,26,1460,0.38
986,01_117_SD_NYM_19,"Paddack, Chris",1478,28,-1,1505,0.48,"Vargas, Jason",1506,-12,22,1516,0.52
987,01_117_BOS_TB_19,"Sale, Chris",1544,38,0,1582,0.54,"Chirinos, Yonny",1533,1,24,1558,0.46
988,01_117_KC_ATL_19,"Duffy, Danny",1446,6,-1,1451,0.34,"Keuchel, Dallas",1530,10,26,1566,0.66
989,01_117_MIA_CHW_20,"Smith, Caleb",1440,10,0,1450,0.47,"Covey, Dylan",1459,-13,24,1470,0.53
990,01_117_OAK_HOU_20,"Fiers, Mike",1539,21,0,1560,0.45,"Miley, Wade",1576,-4,24,1596,0.55
991,01_117_CIN_MIL_20,"Roark, Tanner",1505,-9,0,1496,0.42,"Davies, Zach",1518,8,24,1550,0.58
992,01_117_NYY_MIN_20,"German, Domingo",1584,2,0,1586,0.53,"Gibson, Kyle",1538,2,24,1564,0.47
993,01_117_BAL_ARI_21,"Bundy, Dylan",1408,3,0,1411,0.32,"Kelly, Merrill",1517,1,24,1542,0.68
994,01_117_CHC_SF_21,"Darvish, Yu",1533,6,0,1539,0.51,"Bumgarner, Madison",1485,24,24,1533,0.49
995,01_117_LAA_LAD_22,"Pena, Felix",1512,8,-1,1519,0.38,"Maeda, Kenta",1588,-9,26,1605,0.62
996,01_117_TEX_SEA_22,"Payano, Pedro",1478,-13,0,1465,0.47,Pitcher TBD,1460,4,24,1488,0.53
997,01_118_BOS_TB_12,"Price, David",1545,12,0,1557,0.47,"Morton, Charlie",1532,23,24,1579,0.53
998,01_118_COL_WSH_13,"Gray, Jon",1499,16,0,1515,0.49,"Fedde, Erick",1536,-42,24,1518,0.51
999,01_118_PHI_DET_13,"Velasquez, Vince",1512,-9,0,1503,0.63,"Zimmermann, Jordan",1406,-17,24,1413,0.37
1000,01_118_OAK_HOU_14,"Bassitt, Chris",1540,1,0,1541,0.38,"Verlander, Justin",1575,29,24,1628,0.62
1001,01_118_CIN_MIL_14,"Sims, Lucas",1508,-33,0,1475,0.42,"Chacin, Jhoulys",1514,-7,24,1531,0.58
1002,01_118_BAL_ARI_15,"Means, John",1411,32,0,1443,0.42,"Clarke, Taylor",1513,-40,24,1497,0.58
1003,01_118_TEX_SEA_15,"Minor, Mike",1479,38,0,1517,0.52,"Leake, Mike",1460,18,24,1502,0.48
1004,01_118_CHC_SF_15,"Lester, Jon",1533,-8,0,1525,0.52,"Beede, Tyler",1485,2,24,1511,0.48
1005,01_118_STL_PIT_19,"Wainwright, Adam",1522,-4,0,1518,0.52,"Lyles, Jordan",1493,-14,24,1503,0.48
1006,01_118_COL_WSH_19,"Freeland, Kyle",1499,-2,0,1497,0.4,"Corbin, Patrick",1536,7,24,1567,0.6
1007,01_118_CLE_TOR_19,"Bieber, Shane",1541,10,0,1551,0.55,"Stroman, Marcus",1464,29,24,1517,0.45
1008,01_118_SD_NYM_19,"Lamet, Dinelson",1477,7,0,1484,0.42,"Syndergaard, Noah",1508,6,24,1538,0.58
1009,01_118_KC_ATL_19,"Keller, Brad",1448,14,0,1462,0.36,"Teheran, Julio",1528,12,24,1564,0.64
1010,01_118_NYY_MIN_20,"Happ, J.A.",1584,-2,0,1582,0.52,"Odorizzi, Jake",1538,6,24,1568,0.48
1011,01_118_MIA_CHW_20,"Gallen, Zac",1442,-7,0,1435,0.43,"Lopez, Reynaldo",1457,4,24,1485,0.57
1012,01_118_LAA_LAD_22,"Barria, Jaime",1512,6,0,1518,0.39,"Stripling, Ross",1588,-19,24,1593,0.61
1013,01_119_SD_NYM_12,"Lauer, Eric",1479,3,0,1482,0.38,"deGrom, Jacob",1505,41,24,1570,0.62
1014,01_119_STL_PIT_12,"Mikolas, Miles",1524,13,0,1537,0.51,"Musgrove, Joe",1491,14,24,1529,0.49
1015,01_119_COL_WSH_16,"Hoffman, Jeff",1497,-13,0,1484,0.33,"Scherzer, Max",1538,48,24,1610,0.67
1016,01_119_NYY_BOS_19,"Tanaka, Masahiro",1587,14,-3,1598,0.58,"Porcello, Rick",1544,-23,21,1542,0.42
1017,01_119_MIN_CHW_20,"Berrios, Jose",1535,17,-2,1550,0.56,"Giolito, Lucas",1456,32,24,1512,0.44
1018,01_119_CLE_KC_20,"Plutko, Adam",1543,-37,-3,1503,0.55,"Montgomery, Mike",1450,0,21,1471,0.45
1019,01_119_BAL_LAA_22,"Eshelman, Tom",1410,-10,-2,1398,0.32,"Suarez, Jose",1514,-11,23,1526,0.68
1020,01_119_TEX_OAK_22,"Jurado, Ariel",1477,-14,-3,1460,0.36,"Anderson, Brett",1539,-2,20,1557,0.64
1021,01_119_DET_SEA_22,"VerHagen, Drew",1405,-17,-4,1384,0.35,Pitcher TBD,1461,5,24,1490,0.65
1022,01_120_COL_CIN_18,"Marquez, German",1498,18,-2,1514,0.44,"Castillo, Luis",1507,24,24,1555,0.56
1023,01_120_ATL_PHI_19,"Soroka, Mike",1526,24,-1,1549,0.53,"Arrieta, Jake",1513,-8,24,1529,0.47
1024,01_120_LAD_WSH_19,"Ryu, Hyun-Jin",1585,13,-2,1596,0.58,"Sanchez, Anibal",1537,-18,24,1543,0.42
1025,01_120_TB_TOR_19,"Castillo, Diego",1533,-18,-1,1514,0.54,"Waguespack, Jacob",1463,-3,26,1486,0.46
1026,01_120_NYY_BOS_19,"Paxton, James",1582,6,0,1588,0.54,"Cashner, Andrew",1550,-16,24,1558,0.46
1027,01_120_ARI_MIA_19,"Greinke, Zack",1515,39,-2,1552,0.64,"Alcantara, Sandy",1443,-14,23,1452,0.36
1028,01_120_PIT_NYM_19,"Agrazal, Dario",1489,8,-2,1495,0.45,"Wheeler, Zack",1507,3,24,1534,0.55
1029,01_120_MIN_CHW_20,"Pineda, Michael",1538,2,0,1540,0.6,"Cease, Dylan",1453,-7,24,1470,0.4
1030,01_120_CHC_MIL_20,"Hendricks, Kyle",1533,16,-2,1547,0.5,"Gonzalez, Gio",1515,6,26,1547,0.5
1031,01_120_CLE_KC_20,"Plesac, Zach",1543,-25,0,1518,0.55,"Junis, Jakob",1450,11,24,1485,0.45
1032,01_120_HOU_STL_20,"Urquidy, Jose",1576,-32,-1,1543,0.48,"Flaherty, Jack",1526,13,21,1560,0.52
1033,01_120_BAL_LAA_22,"Wojciechowski, Asher",1410,1,0,1411,0.31,"Canning, Griffin",1515,7,24,1546,0.69
1034,01_120_TEX_OAK_22,"Lynn, Lance",1481,33,0,1514,0.44,"Mengden, Daniel",1535,-5,24,1554,0.56
1035,01_120_SF_SD_22,"Samardzija, Jeff",1484,6,0,1490,0.48,"Lucchesi, Joey",1478,8,20,1506,0.52
1036,01_120_DET_SEA_22,"Norris, Daniel",1403,4,0,1407,0.41,"Kikuchi, Yusei",1463,-14,24,1473,0.59
1037,01_121_TB_TOR_15,"Kittredge, Andrew",1534,-29,0,1505,0.51,"Borucki, Ryan",1461,13,24,1498,0.49
1038,01_121_NYY_BOS_16,"Sabathia, CC",1579,-3,0,1576,0.49,"Rodriguez, Eduardo",1552,10,24,1586,0.51
1039,01_121_LAD_WSH_16,"Kershaw, Clayton",1586,7,0,1593,0.6,"Ross, Joe",1536,-36,24,1524,0.4
1040,01_121_DET_SEA_16,"Alexander, Tyler",1403,13,0,1416,0.38,"Gonzales, Marco",1463,17,24,1504,0.62
1041,01_121_ARI_MIA_18,"Young, Alex",1513,-3,0,1510,0.55,"Yamamoto, Jordan",1445,3,24,1472,0.45
1042,01_121_ATL_PHI_19,"Fried, Max",1529,4,0,1533,0.51,"Eflin, Zach",1511,-9,24,1526,0.49
1043,01_121_MIN_CHW_19,"Perez, Martin",1539,-20,0,1519,0.57,"Nova, Ivan",1452,-3,24,1473,0.43
1044,01_121_COL_CIN_19,"Gonzalez, Chi Chi",1502,-21,0,1481,0.44,"DeSclafani, Anthony",1503,-5,24,1522,0.56
1045,01_121_CHC_MIL_19,"Lester, Jon",1532,-9,0,1523,0.46,"Anderson, Chase",1516,13,24,1553,0.54
1046,01_121_PIT_NYM_19,"Williams, Trevor",1488,12,0,1500,0.49,"Matz, Steven",1508,-25,24,1507,0.51
1047,01_121_CLE_KC_19,"Clevinger, Mike",1546,13,0,1559,0.64,"Sparkman, Glenn",1447,-10,24,1461,0.36
1048,01_121_HOU_STL_19,"Cole, Gerrit",1574,30,0,1604,0.57,"Ponce de Leon, Daniel",1527,7,24,1558,0.43
1049,01_121_SF_SD_20,"Anderson, Shaun",1484,-12,0,1472,0.45,"Quantrill, Cal",1478,2,24,1504,0.55
1050,01_121_BAL_LAA_21,"Brooks, Aaron",1412,-4,0,1408,0.32,Pitcher TBD,1513,1,24,1538,0.68
1051,01_121_TEX_OAK_21,"Sampson, Adrian",1481,-16,0,1465,0.4,"Bailey, Homer",1535,-23,24,1536,0.6
1052,01_122_ATL_PHI_13,"Gausman, Kevin",1532,-4,0,1528,0.44,"Nola, Aaron",1508,39,24,1571,0.56
1053,01_122_TB_TOR_13,"Chirinos, Yonny",1533,2,0,1535,0.58,"Sanchez, Aaron",1462,-9,24,1477,0.42
1054,01_122_COL_CIN_13,"Lambert, Peter",1501,-10,0,1491,0.45,"Wood, Alex",1505,-6,24,1523,0.55
1055,01_122_ARI_MIA_13,"Ray, Robbie",1515,8,0,1523,0.6,"Hernandez, Elieser",1442,-11,24,1455,0.4
1056,01_122_PIT_NYM_13,"Archer, Chris",1486,3,0,1489,0.45,"Vargas, Jason",1510,-10,24,1524,0.55
1057,01_122_LAD_WSH_13,"Buehler, Walker",1588,15,0,1603,0.55,"Strasburg, Stephen",1534,12,24,1570,0.45
1058,01_122_MIN_CHW_14,"Gibson, Kyle",1537,1,0,1538,0.6,"Covey, Dylan",1454,-14,24,1464,0.4
1059,01_122_CHC_MIL_14,"Quintana, Jose",1531,-9,0,1522,0.47,"Davies, Zach",1518,2,24,1544,0.53
1060,01_122_CLE_KC_14,"Bauer, Trevor",1548,10,0,1558,0.61,"Duffy, Danny",1445,11,24,1480,0.39
1061,01_122_HOU_STL_14,"Miley, Wade",1576,-3,0,1573,0.55,"Hudson, Dakota",1525,-10,24,1539,0.45
1062,01_122_BAL_LAA_16,"Bundy, Dylan",1417,5,0,1422,0.34,Pitcher TBD,1508,4,24,1536,0.66
1063,01_122_TEX_OAK_16,"Payano, Pedro",1482,-12,0,1470,0.35,"Fiers, Mike",1534,22,24,1580,0.65
1064,01_122_SF_SD_16,"Bumgarner, Madison",1484,27,0,1511,0.48,"Paddack, Chris",1478,25,24,1527,0.52
1065,01_122_DET_SEA_16,"Boyd, Matthew",1400,29,0,1429,0.42,"Milone, Tommy",1466,-7,24,1483,0.58
1066,01_122_NYY_BOS_19,"German, Domingo",1577,0,0,1577,0.45,"Sale, Chris",1554,37,24,1615,0.55
1067,01_123_ATL_WSH_19,"Keuchel, Dallas",1530,13,-2,1541,0.46,"Corbin, Patrick",1537,6,24,1567,0.54
1068,01_123_PIT_CIN_19,"Lyles, Jordan",1485,-20,-3,1462,0.38,"Gray, Sonny",1505,18,24,1547,0.62
1069,01_123_ARI_MIA_19,"Kelly, Merrill",1513,-6,0,1507,0.54,"Smith, Caleb",1445,13,24,1482,0.46
1070,01_123_TOR_KC_20,"Pannone, Thomas",1462,-10,-3,1449,0.44,"Keller, Brad",1447,20,24,1491,0.56
1071,01_123_LAD_COL_20,"Maeda, Kenta",1585,-10,-4,1571,0.55,"Gray, Jon",1500,14,21,1535,0.45
1072,01_123_DET_LAA_22,"Zimmermann, Jordan",1399,-20,-3,1376,0.28,"Barria, Jaime",1509,9,24,1542,0.72
1073,01_123_BAL_SD_22,Pitcher TBD,1416,5,-1,1420,0.35,"Paddack, Chris",1477,25,24,1526,0.65
1074,01_124_BAL_SD_15,"Eshelman, Tom",1416,-10,0,1406,0.35,"Lamet, Dinelson",1477,8,24,1509,0.65
1075,01_124_ATL_WSH_19,"Teheran, Julio",1528,15,0,1543,0.53,"Fedde, Erick",1538,-43,24,1519,0.47
1076,01_124_ARI_NYY_19,"Clarke, Taylor",1511,-33,-3,1475,0.32,"Happ, J.A.",1579,-1,24,1602,0.68
1077,01_124_SF_PHI_19,"Beede, Tyler",1485,-3,-2,1480,0.43,"Smyly, Drew",1510,-5,26,1531,0.57
1078,01_124_TB_BOS_19,"Morton, Charlie",1533,28,0,1561,0.46,"Price, David",1552,13,26,1591,0.54
1079,01_124_PIT_CIN_19,"Musgrove, Joe",1484,11,0,1495,0.46,"Roark, Tanner",1507,-5,24,1526,0.54
1080,01_124_HOU_CLE_19,"Verlander, Justin",1578,31,0,1609,0.53,"Bieber, Shane",1545,18,23,1586,0.47
1081,01_124_MIN_MIA_19,"Odorizzi, Jake",1539,0,-1,1538,0.59,"Gallen, Zac",1447,4,24,1475,0.41
1082,01_124_SEA_TEX_20,"Leake, Mike",1467,17,-2,1482,0.48,"Jurado, Ariel",1482,-10,22,1494,0.52
1083,01_124_NYM_CHW_20,"Syndergaard, Noah",1511,3,-1,1513,0.54,"Lopez, Reynaldo",1452,10,26,1488,0.46
1084,01_124_TOR_KC_20,"Reid-Foley, Sean",1464,-2,0,1462,0.49,"Montgomery, Mike",1445,3,24,1472,0.51
1085,01_124_CHC_STL_20,"Darvish, Yu",1534,3,0,1537,0.49,"Wainwright, Adam",1524,-4,26,1546,0.51
1086,01_124_LAD_COL_20,"Urias, Julio",1582,-21,0,1561,0.55,"Freeland, Kyle",1503,-1,24,1526,0.45
1087,01_124_DET_LAA_22,"VerHagen, Drew",1399,-25,0,1374,0.28,"Canning, Griffin",1509,9,24,1542,0.72
1088,01_124_MIL_OAK_22,"Houser, Adrian",1515,-24,-2,1489,0.4,"Bassitt, Chris",1534,2,26,1562,0.6
1089,01_125_ATL_WSH_12,"Soroka, Mike",1530,25,0,1555,0.51,"Sanchez, Anibal",1537,-13,24,1548,0.49
1090,01_125_PIT_CIN_12,"Agrazal, Dario",1487,5,0,1492,0.42,"Castillo, Luis",1504,20,24,1548,0.58
1091,01_125_ARI_NYY_13,"Greinke, Zack",1513,39,0,1552,0.42,"Tanaka, Masahiro",1577,5,24,1606,0.58
1092,01_125_TOR_KC_13,"Waguespack, Jacob",1467,-3,0,1464,0.48,"Junis, Jakob",1442,10,24,1476,0.52
1093,01_125_LAD_COL_15,"Ryu, Hyun-Jin",1583,15,0,1598,0.58,"Marquez, German",1501,20,24,1545,0.42
1094,01_125_DET_LAA_16,"Norris, Daniel",1403,5,0,1408,0.34,"Suarez, Jose",1505,-7,24,1522,0.66
1095,01_125_SF_PHI_19,"Samardzija, Jeff",1483,8,0,1491,0.44,"Velasquez, Vince",1511,-4,24,1531,0.56
1096,01_125_TB_BOS_19,"Kittredge, Andrew",1535,-27,0,1508,0.43,"Porcello, Rick",1551,-19,24,1556,0.57
1097,01_125_HOU_CLE_19,"Urquidy, Jose",1579,-28,0,1551,0.5,"Plesac, Zach",1544,-19,24,1549,0.5
1098,01_125_MIN_MIA_19,"Berrios, Jose",1540,17,0,1557,0.64,"Alcantara, Sandy",1446,-13,24,1457,0.36
1099,01_125_CHC_STL_20,"Hendricks, Kyle",1533,17,0,1550,0.48,"Mikolas, Miles",1525,14,24,1563,0.52
1100,01_125_SEA_TEX_20,Pitcher TBD,1468,4,0,1472,0.41,"Minor, Mike",1480,34,24,1538,0.59
1101,01_125_NYM_CHW_20,"deGrom, Jacob",1512,41,0,1553,0.58,"Giolito, Lucas",1450,26,24,1500,0.42
1102,01_125_MIL_OAK_22,"Gonzalez, Gio",1515,10,0,1525,0.46,"Anderson, Brett",1534,-4,24,1554,0.54
1103,01_126_MIN_MIA_12,"Pineda, Michael",1541,1,0,1542,0.61,"Yamamoto, Jordan",1445,-2,24,1467,0.39
1104,01_126_SF_PHI_13,"Rodriguez, Dereck",1486,5,0,1491,0.45,"Arrieta, Jake",1509,-8,24,1525,0.55
1105,01_126_NYM_CHW_14,"Wheeler, Zack",1513,0,0,1513,0.57,"Cease, Dylan",1449,-11,24,1462,0.43
1106,01_126_MIL_OAK_15,"Anderson, Chase",1514,14,0,1528,0.46,"Mengden, Daniel",1535,-6,24,1553,0.54
1107,01_126_TOR_BAL_19,"Thornton, Trent",1468,-1,-3,1464,0.52,"Wojciechowski, Asher",1417,10,22,1449,0.48
1108,01_126_TB_BOS_19,"McKay, Brendan",1537,-22,0,1515,0.43,"Cashner, Andrew",1549,-11,24,1562,0.57
1109,01_126_HOU_CLE_19,"Cole, Gerrit",1577,29,0,1606,0.57,"Salazar, Danny",1547,-13,24,1558,0.43
1110,01_126_CHC_STL_19,"Lester, Jon",1534,-6,0,1528,0.45,"Flaherty, Jack",1523,17,24,1564,0.55
1111,01_126_CIN_ATL_19,"DeSclafani, Anthony",1505,-2,-2,1501,0.43,"Fried, Max",1531,1,21,1553,0.57
1112,01_126_SD_LAD_22,"Lucchesi, Joey",1476,10,1,1487,0.32,"Kershaw, Clayton",1585,11,21,1617,0.68
1113,01_137_BAL_NYY_13,"Ynoa, Gabriel",1409,-8,-2,1399,0.22,"Paxton, James",1586,7,22,1615,0.78
1114,01_137_BOS_CLE_19,"Rodriguez, Eduardo",1538,16,-3,1551,0.49,"Plesac, Zach",1555,-20,21,1556,0.51
1115,01_137_BAL_NYY_19,Pitcher TBD,1409,4,0,1413,0.24,Pitcher TBD,1586,1,24,1611,0.76
1116,01_137_CIN_WSH_19,"DeSclafani, Anthony",1510,-8,-2,1500,0.48,"Fedde, Erick",1537,-44,22,1515,0.52
1117,01_137_TEX_TOR_19,"Jurado, Ariel",1481,-11,-2,1468,0.46,"Ramirez, Neil",1475,-2,24,1497,0.54
1118,01_137_HOU_CHW_20,"Greinke, Zack",1588,12,-3,1597,0.68,"Cease, Dylan",1452,-10,24,1466,0.32
1119,01_137_ARI_COL_20,"Kelly, Merrill",1515,-12,-3,1500,0.51,"Lambert, Peter",1494,-20,21,1495,0.49
1120,01_137_PIT_LAA_22,"Keller, Mitch",1473,-13,-4,1456,0.44,"Suarez, Jose",1495,-19,20,1496,0.56
1121,01_137_TB_SD_22,"Castillo, Diego",1542,-18,-3,1521,0.51,"Lucchesi, Joey",1481,9,24,1514,0.49
1122,01_138_HOU_CHW_16,"Greinke, Zack",1588,12,-1,1599,0.68,"Cease, Dylan",1452,-10,26,1468,0.32
1123,01_138_BAL_NYY_19,"Means, John",1408,30,0,1438,0.27,"German, Domingo",1587,1,24,1612,0.73
1124,01_138_CHC_PHI_19,"Quintana, Jose",1537,1,0,1538,0.51,"Vargas, Jason",1502,4,22,1528,0.49
1125,01_138_CIN_WSH_19,"Wood, Alex",1509,-10,0,1499,0.45,"Ross, Joe",1538,-26,24,1536,0.55
1126,01_138_TEX_TOR_19,"Lynn, Lance",1477,40,0,1517,0.54,"Pannone, Thomas",1479,-16,24,1487,0.46
1127,01_138_BOS_CLE_19,"Sale, Chris",1537,41,0,1578,0.47,"Clevinger, Mike",1556,19,24,1599,0.53
1128,01_138_SEA_DET_19,"Kikuchi, Yusei",1459,-16,-2,1441,0.49,"Boyd, Matthew",1398,25,26,1449,0.51
1129,01_138_LAD_MIA_19,"Kershaw, Clayton",1591,8,-2,1597,0.68,"Yamamoto, Jordan",1443,1,26,1470,0.32
1130,01_138_NYM_ATL_19,"Wheeler, Zack",1523,7,-1,1529,0.46,"Fried, Max",1530,7,23,1560,0.54
1131,01_138_HOU_CHW_20,"Cole, Gerrit",1588,30,0,1618,0.69,"Nova, Ivan",1452,4,24,1480,0.31
1132,01_138_MIN_MIL_20,"Perez, Martin",1536,-28,0,1508,0.43,"Anderson, Chase",1515,14,26,1555,0.57
1133,01_138_STL_KC_20,"Flaherty, Jack",1522,28,0,1550,0.65,"Sparkman, Glenn",1441,-18,23,1446,0.35
1134,01_138_ARI_COL_20,"Gallen, Zac",1516,15,0,1531,0.5,"Gray, Jon",1492,15,24,1531,0.5
1135,01_138_OAK_SF_21,"Anderson, Brett",1539,-6,-2,1531,0.49,"Bumgarner, Madison",1481,29,26,1536,0.51
1136,01_138_PIT_LAA_22,"Williams, Trevor",1477,10,0,1487,0.43,"Canning, Griffin",1491,18,24,1533,0.57
1137,01_138_TB_SD_22,"McKay, Brendan",1544,-23,0,1521,0.53,"Lauer, Eric",1479,-4,24,1499,0.47
1138,01_139_TEX_TOR_12,"Allard, Kolby",1476,-16,0,1460,0.44,"Reid-Foley, Sean",1481,-1,24,1504,0.56
1139,01_139_BAL_NYY_13,"Bundy, Dylan",1407,15,0,1422,0.26,"Happ, J.A.",1588,-9,24,1603,0.74
1140,01_139_BOS_CLE_13,"Johnson, Brian",1538,-16,0,1522,0.39,"Bieber, Shane",1555,21,24,1600,0.61
1141,01_139_HOU_CHW_14,"Miley, Wade",1587,-3,0,1584,0.67,"Detwiler, Ross",1454,-16,24,1462,0.33
1142,01_139_MIN_MIL_14,"Gibson, Kyle",1538,1,0,1539,0.49,"Gonzalez, Gio",1513,9,24,1546,0.51
1143,01_139_ARI_COL_15,"Ray, Robbie",1518,12,0,1530,0.53,"Freeland, Kyle",1490,-2,24,1512,0.47
1144,01_139_TB_SD_15,"Kittredge, Andrew",1544,-26,0,1518,0.51,"Quantrill, Cal",1479,8,24,1511,0.49
1145,01_139_OAK_SF_15,"Bailey, Homer",1538,-25,0,1513,0.53,"Beede, Tyler",1482,-13,24,1493,0.47
1146,01_139_CIN_WSH_16,"Bauer, Trevor",1508,18,0,1526,0.43,"Strasburg, Stephen",1540,10,24,1574,0.57
1147,01_139_CHC_PHI_19,"Hamels, Cole",1536,13,0,1549,0.48,"Nola, Aaron",1504,36,24,1564,0.52
1148,01_139_SEA_DET_19,"Gonzales, Marco",1461,22,0,1483,0.61,"Jackson, Edwin",1396,-17,24,1403,0.39
1149,01_139_LAD_MIA_19,"Kershaw, Clayton",1594,8,0,1602,0.7,"Hernandez, Elieser",1440,-6,24,1458,0.3
1150,01_139_NYM_ATL_19,"Matz, Steven",1521,-20,0,1501,0.42,"Keuchel, Dallas",1531,-1,24,1554,0.58
1151,01_139_PIT_LAA_20,"Archer, Chris",1477,10,0,1487,0.47,"Peters, Dillon",1491,-9,24,1506,0.53
1152,01_139_STL_KC_20,"Hudson, Dakota",1523,-19,0,1504,0.53,"Keller, Brad",1440,18,24,1482,0.47
1153,01_140_SEA_DET_13,"Tuivailala, Sam",1460,9,0,1469,0.54,"Turnbull, Spencer",1397,18,24,1439,0.46
1154,01_140_LAD_MIA_15,"Buehler, Walker",1596,14,0,1610,0.69,"Smith, Caleb",1438,10,24,1472,0.31
1155,01_140_CLE_NYY_19,"Plutko, Adam",1553,-38,-2,1513,0.36,"Green, Chad",1588,-3,24,1609,0.64
1156,01_140_CHC_PHI_19,"Darvish, Yu",1532,9,0,1541,0.53,"Smyly, Drew",1507,-8,24,1523,0.47
1157,01_140_STL_CIN_19,"Wacha, Michael",1525,-24,-3,1498,0.43,"Gray, Sonny",1505,23,22,1550,0.57
1158,01_140_NYM_ATL_19,"Stroman, Marcus",1520,1,0,1521,0.43,"Teheran, Julio",1532,13,24,1569,0.57
1159,01_140_MIN_TEX_20,"Smeltzer, Devin",1537,-12,-3,1522,0.56,"Payano, Pedro",1478,-21,21,1478,0.44
1160,01_140_SF_ARI_21,"Rodriguez, Dereck",1480,-1,-3,1476,0.42,"Young, Alex",1517,-5,21,1533,0.58
1161,01_140_CHW_LAA_22,"Lopez, Reynaldo",1457,8,-4,1461,0.4,"Heaney, Andrew",1491,16,24,1531,0.6
1162,01_140_HOU_OAK_22,"Sanchez, Aaron",1584,-36,-4,1544,0.44,"Fiers, Mike",1539,22,23,1584,0.56
1163,01_141_CLE_NYY_19,"Civale, Aaron",1558,-14,0,1544,0.4,"Tanaka, Masahiro",1583,7,24,1614,0.6
1164,01_141_SD_PHI_19,"Paddack, Chris",1480,18,-2,1496,0.45,"Velasquez, Vince",1508,-1,24,1531,0.55
1165,01_141_CHC_PIT_19,"Hendricks, Kyle",1531,13,-2,1542,0.55,"Musgrove, Joe",1477,6,22,1505,0.45
1166,01_141_MIL_WSH_19,"Houser, Adrian",1514,-12,-1,1501,0.39,"Corbin, Patrick",1543,9,26,1578,0.61
1167,01_141_SEA_TOR_19,Pitcher TBD,1462,4,-2,1464,0.43,"Waguespack, Jacob",1478,6,26,1510,0.57
1168,01_141_BAL_BOS_19,"Brooks, Aaron",1407,-16,0,1391,0.29,"Porcello, Rick",1541,-15,23,1549,0.71
1169,01_141_STL_CIN_19,"Wainwright, Adam",1525,-3,0,1522,0.45,"Castillo, Luis",1506,27,24,1557,0.55
1170,01_141_DET_TB_19,"Norris, Daniel",1395,3,-3,1395,0.24,"Morton, Charlie",1544,25,22,1591,0.76
1171,01_141_LAD_ATL_19,"Maeda, Kenta",1592,-15,-3,1574,0.48,"Soroka, Mike",1531,31,24,1586,0.52
1172,01_141_MIN_TEX_20,"Odorizzi, Jake",1539,7,0,1546,0.51,"Minor, Mike",1476,40,24,1540,0.49
1173,01_141_NYM_KC_20,"Syndergaard, Noah",1522,11,-3,1530,0.58,"Montgomery, Mike",1438,7,26,1471,0.42
1174,01_141_MIA_COL_20,"Alcantara, Sandy",1442,-8,-4,1430,0.35,"Gray, Jon",1491,17,26,1534,0.65
1175,01_141_SF_ARI_21,"Samardzija, Jeff",1483,18,0,1501,0.47,"Leake, Mike",1514,-18,24,1520,0.53
1176,01_141_CHW_LAA_22,"Giolito, Lucas",1457,28,0,1485,0.46,"Sandoval, Patrick",1491,-3,24,1512,0.54
1177,01_141_HOU_OAK_22,"Verlander, Justin",1583,37,0,1620,0.58,"Roark, Tanner",1540,-1,24,1563,0.42
1178,01_142_CLE_NYY_13,"Plesac, Zach",1557,-21,0,1536,0.39,"Paxton, James",1583,7,24,1614,0.61
1179,01_142_CHC_PIT_13,"Lester, Jon",1530,-16,0,1514,0.51,"Brault, Steven",1478,3,24,1505,0.49
1180,01_142_SEA_TOR_15,"McClain, Reggie",1460,7,0,1467,0.45,"Thornton, Trent",1480,-1,24,1503,0.55
1181,01_142_HOU_OAK_16,"Armenteros, Rogelio",1583,-31,0,1552,0.47,"Bassitt, Chris",1540,6,24,1570,0.53
1182,01_142_DET_TB_18,"VerHagen, Drew",1398,-22,0,1376,0.24,"Yarbrough, Ryan",1541,8,24,1573,0.76
1183,01_142_STL_CIN_18,"Mikolas, Miles",1528,9,0,1537,0.53,"DeSclafani, Anthony",1503,-10,24,1517,0.47
1184,01_142_SD_PHI_19,"Lamet, Dinelson",1478,13,0,1491,0.46,"Eflin, Zach",1510,-18,24,1516,0.54
1185,01_142_MIL_WSH_19,"Lyles, Jordan",1514,-20,0,1494,0.41,"Sanchez, Anibal",1543,-13,24,1554,0.59
1186,01_142_BAL_BOS_19,"Wojciechowski, Asher",1406,7,0,1413,0.28,"Rodriguez, Eduardo",1542,10,24,1576,0.72
1187,01_142_NYM_KC_19,"deGrom, Jacob",1520,41,0,1561,0.62,"Junis, Jakob",1440,12,24,1476,0.38
1188,01_142_LAD_ATL_19,"Ryu, Hyun-Jin",1594,18,0,1612,0.59,"Foltynewicz, Mike",1529,-2,24,1551,0.41
1189,01_142_MIN_TEX_20,"Berrios, Jose",1540,16,0,1556,0.61,"Jurado, Ariel",1475,-18,24,1481,0.39
1190,01_142_SF_ARI_20,"Webb, Logan",1483,-5,0,1478,0.44,"Clarke, Taylor",1514,-20,24,1518,0.56
1191,01_142_MIA_COL_20,"Noesi, Hector",1441,-17,0,1424,0.33,"Marquez, German",1492,28,24,1544,0.67
1192,01_142_CHW_LAA_21,"Santiago, Hector",1456,-21,0,1435,0.42,"Suarez, Jose",1492,-26,24,1490,0.58
1193,01_143_BAL_BOS_13,"Blach, Ty",1405,-12,0,1393,0.27,"Eovaldi, Nathan",1543,1,24,1568,0.73
1194,01_143_CLE_NYY_13,"Clevinger, Mike",1557,16,0,1573,0.46,"Sabathia, CC",1584,-7,24,1601,0.54
1195,01_143_SD_PHI_13,"Lucchesi, Joey",1479,8,0,1487,0.43,"Vargas, Jason",1509,4,24,1537,0.57
1196,01_143_SEA_TOR_13,"Kikuchi, Yusei",1461,-20,0,1441,0.39,"Font, Wilmer",1479,14,24,1517,0.61
1197,01_143_STL_CIN_13,"Flaherty, Jack",1526,32,0,1558,0.55,"Wood, Alex",1505,-9,24,1520,0.45
1198,01_143_DET_TB_13,"Boyd, Matthew",1397,17,0,1414,0.3,Pitcher TBD,1541,-1,24,1564,0.7
1199,01_143_LAD_ATL_13,"Gonsolin, Tony",1593,-33,0,1560,0.5,"Fried, Max",1530,9,24,1563,0.5
1200,01_143_MIL_WSH_13,"Anderson, Chase",1515,15,0,1530,0.51,"Fedde, Erick",1542,-41,24,1525,0.49
1201,01_143_NYM_KC_14,"Wheeler, Zack",1521,0,0,1521,0.61,"Sparkman, Glenn",1439,-16,24,1447,0.39
1202,01_143_MIN_TEX_15,"Perez, Martin",1541,-25,0,1516,0.47,"Lynn, Lance",1473,41,24,1538,0.53
1203,01_143_MIA_COL_15,"Yamamoto, Jordan",1439,-1,0,1438,0.41,"Lambert, Peter",1494,-18,24,1500,0.59
1204,01_143_CHW_LAA_16,"Cease, Dylan",1457,-13,0,1444,0.38,"Canning, Griffin",1490,15,24,1529,0.62
1205,01_143_HOU_OAK_16,"Greinke, Zack",1580,14,0,1594,0.55,"Anderson, Brett",1543,-5,24,1562,0.45
1206,01_143_SF_ARI_16,"Bumgarner, Madison",1487,32,0,1519,0.49,"Kelly, Merrill",1511,-12,24,1523,0.51
1207,01_143_CHC_PIT_19,"Quintana, Jose",1531,3,0,1534,0.6,"Keller, Mitch",1477,-12,0,1465,0.4
1208,01_144_KC_BAL_19,"Lopez, Jorge",1437,-30,-3,1404,0.43,"Means, John",1404,24,22,1450,0.57
1209,01_144_WSH_PIT_19,"Ross, Joe",1545,-20,-2,1523,0.53,"Williams, Trevor",1475,5,24,1504,0.47
1210,01_144_SD_CIN_19,"Lauer, Eric",1481,-5,-2,1474,0.41,"Bauer, Trevor",1504,12,24,1540,0.59
1211,01_144_SEA_TB_19,"Gonzales, Marco",1465,18,-3,1480,0.42,"McKay, Brendan",1542,-28,24,1538,0.58
1212,01_144_MIL_STL_19,"Davies, Zach",1512,-6,-3,1503,0.46,"Hudson, Dakota",1527,-15,22,1534,0.54
1213,01_144_LAA_TEX_20,"Peters, Dillon",1492,-4,-3,1485,0.5,"Allard, Kolby",1472,-11,24,1485,0.5
1214,01_144_DET_HOU_20,"Jackson, Edwin",1397,-19,-3,1375,0.22,"Miley, Wade",1582,-8,20,1594,0.78
1215,01_144_CHW_MIN_20,"Nova, Ivan",1456,12,-4,1464,0.36,"Gibson, Kyle",1543,0,21,1564,0.64
1216,01_144_COL_ARI_21,"Gonzalez, Chi Chi",1495,-24,-3,1468,0.38,"Gallen, Zac",1513,15,24,1552,0.62
1217,01_145_LAA_TEX_14,"Heaney, Andrew",1491,17,0,1508,0.53,"Burke, Brock",1473,-10,24,1487,0.47
1218,01_145_KC_BAL_19,"Keller, Brad",1438,17,0,1455,0.52,"Bundy, Dylan",1403,14,24,1441,0.48
1219,01_145_WSH_PIT_19,"Strasburg, Stephen",1549,9,0,1558,0.57,"Archer, Chris",1471,12,24,1507,0.43
1220,01_145_PHI_BOS_19,"Nola, Aaron",1507,40,0,1547,0.49,"Johnson, Brian",1544,-16,26,1554,0.51
1221,01_145_SD_CIN_19,"Quantrill, Cal",1482,9,0,1491,0.41,"Gray, Sonny",1503,28,24,1555,0.59
1222,01_145_CLE_NYM_19,"Bieber, Shane",1559,20,1,1580,0.57,"Matz, Steven",1523,-17,23,1529,0.43
1223,01_145_SEA_TB_19,Pitcher TBD,1468,5,0,1473,0.37,Pitcher TBD,1539,1,24,1564,0.63
1224,01_145_MIA_ATL_19,"Hernandez, Elieser",1439,-11,-1,1427,0.31,"Keuchel, Dallas",1531,5,26,1562,0.69
1225,01_145_MIL_STL_19,"Gonzalez, Gio",1510,6,0,1516,0.48,"Wacha, Michael",1528,-23,24,1529,0.52
1226,01_145_SF_CHC_20,"Beede, Tyler",1484,-18,-2,1464,0.37,"Hamels, Cole",1533,1,24,1558,0.63
1227,01_145_LAA_TEX_20,Pitcher TBD,1491,-1,0,1490,0.52,"Palumbo, Joe",1473,-23,24,1474,0.48
1228,01_145_DET_HOU_20,"Turnbull, Spencer",1397,16,0,1413,0.29,"Sanchez, Aaron",1582,-40,24,1566,0.71
1229,01_145_CHW_MIN_20,"Lopez, Reynaldo",1457,5,0,1462,0.35,"Pineda, Michael",1541,6,24,1571,0.65
1230,01_145_COL_ARI_21,"Freeland, Kyle",1494,-5,0,1489,0.44,"Young, Alex",1514,-10,24,1528,0.56
1231,01_145_NYY_OAK_22,"German, Domingo",1582,5,-2,1585,0.55,"Bailey, Homer",1542,-18,26,1550,0.45
1232,01_145_TOR_LAD_22,"Reid-Foley, Sean",1476,-3,-2,1471,0.29,"Kershaw, Clayton",1592,13,22,1627,0.71
1233,01_146_SD_CIN_12,"Strahm, Matt",1481,-6,0,1475,0.4,"Castillo, Luis",1504,18,24,1546,0.6
1234,01_146_CHW_MIN_13,"Giolito, Lucas",1455,30,0,1485,0.37,"Odorizzi, Jake",1543,10,24,1577,0.63
1235,01_146_SEA_TB_13,Pitcher TBD,1470,6,0,1476,0.34,"Morton, Charlie",1537,31,24,1592,0.66
1236,01_146_COL_ARI_15,"Gray, Jon",1493,22,0,1515,0.49,"Leake, Mike",1514,-19,24,1519,0.51
1237,01_146_KC_BAL_19,"Montgomery, Mike",1437,8,0,1445,0.55,"Brooks, Aaron",1404,-16,24,1412,0.45
1238,01_146_WSH_PIT_19,"Corbin, Patrick",1547,9,0,1556,0.57,"Musgrove, Joe",1473,12,24,1509,0.43
1239,01_146_LAA_TEX_19,"Sandoval, Patrick",1492,-6,0,1486,0.43,"Minor, Mike",1472,40,24,1536,0.57
1240,01_146_PHI_BOS_19,"Smyly, Drew",1508,-11,0,1497,0.42,"Porcello, Rick",1543,-12,24,1555,0.58
1241,01_146_CLE_NYM_19,"Plutko, Adam",1556,-36,0,1520,0.46,"Stroman, Marcus",1526,-2,24,1548,0.54
1242,01_146_MIA_ATL_19,"Smith, Caleb",1438,10,0,1448,0.34,"Teheran, Julio",1532,6,24,1562,0.66
1243,01_146_MIL_STL_19,"Houser, Adrian",1508,0,0,1508,0.44,"Wainwright, Adam",1530,-4,24,1550,0.56
1244,01_146_SF_CHC_20,"Rodriguez, Dereck",1483,4,0,1487,0.38,"Darvish, Yu",1534,12,24,1570,0.62
1245,01_146_DET_HOU_20,"Norris, Daniel",1396,3,0,1399,0.19,"Verlander, Justin",1583,39,24,1646,0.81
1246,01_146_NYY_OAK_22,"Happ, J.A.",1580,-6,0,1574,0.48,"Fiers, Mike",1544,18,24,1586,0.52
1247,01_146_TOR_LAD_22,"Waguespack, Jacob",1476,10,0,1486,0.31,"Buehler, Walker",1592,10,24,1626,0.69
1248,01_147_SF_CHC_14,"Samardzija, Jeff",1483,19,0,1502,0.4,"Hendricks, Kyle",1535,15,24,1574,0.6
1249,01_147_TB_BAL_19,"Yarbrough, Ryan",1537,17,-3,1551,0.66,"Wojciechowski, Asher",1407,6,24,1437,0.34
1250,01_147_WSH_PIT_19,"Scherzer, Max",1550,47,0,1597,0.63,"Brault, Steven",1470,12,24,1506,0.37
1251,01_147_CLE_NYM_19,"Civale, Aaron",1555,-13,0,1542,0.47,"Syndergaard, Noah",1527,11,24,1562,0.53
1252,01_147_MIA_ATL_19,"Alcantara, Sandy",1436,-5,0,1431,0.29,"Soroka, Mike",1534,29,24,1587,0.71
1253,01_147_COL_STL_19,"Marquez, German",1496,27,-3,1520,0.44,"Mikolas, Miles",1529,5,24,1558,0.56
1254,01_147_TEX_CHW_20,"Jurado, Ariel",1473,-22,-3,1448,0.48,"Detwiler, Ross",1458,-17,22,1463,0.52
1255,01_147_DET_HOU_20,"Zimmermann, Jordan",1398,-8,0,1390,0.19,"Cole, Gerrit",1581,32,24,1637,0.81
1256,01_147_NYY_OAK_21,"Tanaka, Masahiro",1580,10,0,1590,0.53,"Roark, Tanner",1544,0,24,1568,0.47
1257,01_147_TOR_LAD_22,"Waguespack, Jacob",1474,11,0,1485,0.33,"Maeda, Kenta",1593,-14,24,1603,0.67
1258,01_148_WSH_CHC_14,"Sanchez, Anibal",1551,-18,-2,1531,0.48,"Lester, Jon",1535,-15,24,1544,0.52
1259,01_148_TB_BAL_19,Pitcher TBD,1538,-4,0,1534,0.66,"Blach, Ty",1406,-13,24,1417,0.34
1260,01_148_CIN_PIT_19,"DeSclafani, Anthony",1505,-11,0,1494,0.52,"Keller, Mitch",1469,-16,24,1477,0.48
1261,01_148_KC_CLE_19,"Junis, Jakob",1433,14,0,1447,0.36,"Plesac, Zach",1553,-25,22,1550,0.64
1262,01_148_PHI_MIA_19,"Velasquez, Vince",1510,-1,-1,1508,0.61,"Noesi, Hector",1436,-23,21,1434,0.39
1263,01_148_ATL_NYM_19,"Foltynewicz, Mike",1534,-4,-3,1527,0.41,"deGrom, Jacob",1528,42,24,1594,0.59
1264,01_148_TEX_CHW_20,"Lynn, Lance",1471,41,0,1512,0.57,"Cease, Dylan",1460,-19,24,1465,0.43
1265,01_148_LAA_HOU_20,"Suarez, Jose",1491,-31,0,1460,0.29,"Greinke, Zack",1581,15,24,1620,0.71
1266,01_148_ARI_MIL_20,"Kelly, Merrill",1512,-9,-2,1501,0.48,"Lyles, Jordan",1510,-22,24,1512,0.52
1267,01_148_DET_MIN_20,"Boyd, Matthew",1398,21,-3,1416,0.28,"Berrios, Jose",1541,11,26,1578,0.72
1268,01_148_COL_STL_20,"Lambert, Peter",1495,-16,0,1479,0.35,"Flaherty, Jack",1530,32,24,1586,0.65
1269,01_148_NYY_LAD_22,"Paxton, James",1577,9,-2,1584,0.43,"Ryu, Hyun-Jin",1595,15,24,1634,0.57
1270,01_148_BOS_SD_22,"Rodriguez, Eduardo",1542,14,-2,1554,0.56,"Paddack, Chris",1480,12,22,1514,0.44
1271,01_148_TOR_SEA_22,"Thornton, Trent",1472,-2,-3,1467,0.46,"Sheffield, Justus",1469,5,22,1496,0.54
1272,01_149_WSH_CHC_14,"Ross, Joe",1554,-21,0,1533,0.45,"Quintana, Jose",1533,8,24,1565,0.55
1273,01_149_NYY_LAD_16,"Sabathia, CC",1577,-7,0,1570,0.47,"Gonsolin, Tony",1595,-30,24,1589,0.53
1274,01_149_PHI_MIA_18,"Eflin, Zach",1507,-18,0,1489,0.53,"Yamamoto, Jordan",1440,4,24,1468,0.47
1275,01_149_TB_BAL_19,Pitcher TBD,1540,-6,0,1534,0.61,"Means, John",1405,24,24,1453,0.39
1276,01_149_CIN_PIT_19,"Wood, Alex",1503,-14,0,1489,0.5,"Williams, Trevor",1470,-4,24,1490,0.5
1277,01_149_TEX_CHW_19,"Allard, Kolby",1468,-14,0,1454,0.44,"Nova, Ivan",1462,9,24,1495,0.56
1278,01_149_KC_CLE_19,"Sparkman, Glenn",1432,-15,0,1417,0.26,"Clevinger, Mike",1554,18,24,1596,0.74
1279,01_149_LAA_HOU_19,"Peters, Dillon",1490,-9,0,1481,0.34,"Miley, Wade",1581,-11,24,1594,0.66
1280,01_149_ARI_MIL_19,"Gallen, Zac",1510,18,0,1528,0.48,"Anderson, Chase",1512,2,24,1538,0.52
1281,01_149_DET_MIN_19,"Jackson, Edwin",1401,-20,0,1381,0.26,"Gibson, Kyle",1538,0,24,1562,0.74
1282,01_149_ATL_NYM_19,"Fried, Max",1535,6,0,1541,0.49,"Wheeler, Zack",1527,-3,24,1548,0.51
1283,01_149_COL_STL_19,"Gonzalez, Chi Chi",1493,-20,0,1473,0.4,"Hudson, Dakota",1531,-10,24,1545,0.6
1284,01_149_BOS_SD_20,"Eovaldi, Nathan",1542,-3,0,1539,0.53,"Lamet, Dinelson",1480,12,24,1516,0.47
1285,01_149_SF_OAK_21,"Bumgarner, Madison",1482,31,-2,1511,0.41,"Bassitt, Chris",1547,5,26,1578,0.59
1286,01_149_TOR_SEA_21,Pitcher TBD,1472,3,0,1475,0.5,"Hernandez, Felix",1469,-15,24,1478,0.5
1287,01_150_TB_BAL_13,"Castillo, Diego",1537,-20,0,1517,0.6,"Bundy, Dylan",1408,17,24,1449,0.4
1288,01_150_KC_CLE_13,"Skoglund, Eric",1431,-7,0,1424,0.27,"Bieber, Shane",1555,17,24,1596,0.73
1289,01_150_PHI_MIA_13,"Nola, Aaron",1509,43,0,1552,0.64,"Hernandez, Elieser",1437,-8,24,1453,0.36
1290,01_150_ATL_NYM_13,"Keuchel, Dallas",1537,3,0,1540,0.51,"Matz, Steven",1525,-16,24,1533,0.49
1291,01_150_CIN_PIT_13,"Bauer, Trevor",1499,13,0,1512,0.53,"Agrazal, Dario",1474,-6,24,1492,0.47
1292,01_150_TEX_CHW_14,"Burke, Brock",1470,0,0,1470,0.48,"Lopez, Reynaldo",1460,0,24,1484,0.52
1293,01_150_LAA_HOU_14,"Barria, Jaime",1489,7,0,1496,0.41,"Valdez, Framber",1582,-45,24,1561,0.59
1294,01_150_ARI_MIL_14,"Ray, Robbie",1508,17,0,1525,0.49,"Davies, Zach",1514,-7,24,1531,0.51
1295,01_150_DET_MIN_14,"Boyd, Matthew",1400,21,0,1421,0.33,"Perez, Martin",1538,-21,24,1541,0.67
1296,01_150_COL_STL_14,"Senzatela, Antonio",1491,-18,0,1473,0.41,"Wacha, Michael",1533,-20,24,1537,0.59
1297,01_150_WSH_CHC_14,"Strasburg, Stephen",1556,11,0,1567,0.52,"Hamels, Cole",1530,1,24,1555,0.48
1298,01_150_SF_OAK_16,"Webb, Logan",1485,-1,0,1484,0.39,"Anderson, Brett",1544,-9,24,1559,0.61
1299,01_150_BOS_SD_16,"Johnson, Brian",1546,-16,0,1530,0.53,"Lucchesi, Joey",1476,11,24,1511,0.47
1300,01_150_TOR_SEA_16,"Buchholz, Clay",1472,18,0,1490,0.47,"Gonzales, Marco",1469,17,24,1510,0.53
1301,01_150_NYY_LAD_19,"German, Domingo",1579,1,0,1580,0.43,"Kershaw, Clayton",1592,10,24,1626,0.57
1302,01_151_ATL_COL_15,"Teheran, Julio",1538,6,-4,1540,0.56,"Melville, Tim",1489,-13,21,1497,0.44
1303,01_151_STL_MIL_19,"Wainwright, Adam",1535,-9,-2,1524,0.47,"Gonzalez, Gio",1512,6,24,1542,0.53
1304,01_151_PIT_PHI_19,"Musgrove, Joe",1475,7,-2,1480,0.43,"Vargas, Jason",1507,4,21,1532,0.57
1305,01_151_CIN_MIA_19,"Gray, Sonny",1498,30,-3,1525,0.57,"Lopez, Pablo",1439,11,24,1474,0.43
1306,01_151_OAK_KC_20,"Bailey, Homer",1543,-15,-4,1524,0.57,"Keller, Brad",1433,22,21,1476,0.43
1307,01_151_ARI_SF_21,"Young, Alex",1510,-9,-4,1497,0.51,"Beede, Tyler",1486,-20,23,1489,0.49
1308,01_151_NYY_SEA_22,"Happ, J.A.",1582,-9,-3,1570,0.6,Pitcher TBD,1471,5,24,1500,0.4
1309,01_151_LAD_SD_22,"May, Dustin",1590,-30,-1,1559,0.59,"Lauer, Eric",1477,-4,24,1497,0.41
1310,01_152_PIT_PHI_19,"Brault, Steven",1474,11,0,1485,0.45,"Smyly, Drew",1508,-10,24,1522,0.55
1311,01_152_BAL_WSH_19,"Brooks, Aaron",1410,-14,1,1397,0.24,"Corbin, Patrick",1558,12,23,1593,0.76
1312,01_152_ATL_TOR_19,"Soroka, Mike",1537,28,-3,1562,0.59,Pitcher TBD,1471,7,22,1500,0.41
1313,01_152_CLE_DET_19,"Plutko, Adam",1553,-34,1,1520,0.62,"Turnbull, Spencer",1399,10,23,1432,0.38
1314,01_152_CIN_MIA_19,"Castillo, Luis",1499,22,0,1521,0.57,"Smith, Caleb",1437,10,24,1471,0.43
1315,01_152_CHC_NYM_19,"Darvish, Yu",1529,8,-1,1536,0.49,"Stroman, Marcus",1524,-4,26,1546,0.51
1316,01_152_STL_MIL_19,"Mikolas, Miles",1539,2,0,1541,0.51,"Houser, Adrian",1509,0,24,1533,0.49
1317,01_152_MIN_CHW_20,"Pineda, Michael",1539,6,0,1545,0.53,"Giolito, Lucas",1461,35,26,1522,0.47
1318,01_152_TB_HOU_20,"Morton, Charlie",1534,29,-1,1562,0.37,"Verlander, Justin",1585,40,26,1651,0.63
1319,01_152_OAK_KC_20,"Fiers, Mike",1546,17,0,1563,0.65,"Montgomery, Mike",1430,5,24,1459,0.35
1320,01_152_BOS_COL_20,"Porcello, Rick",1544,-11,-1,1532,0.54,"Garcia, Rico",1491,-10,24,1505,0.46
1321,01_152_ARI_SF_21,"Leake, Mike",1510,-19,0,1491,0.44,"Samardzija, Jeff",1486,24,24,1534,0.56
1322,01_152_TEX_LAA_22,"Minor, Mike",1469,36,-2,1503,0.46,"Heaney, Andrew",1487,24,23,1534,0.54
1323,01_152_LAD_SD_22,"Buehler, Walker",1590,14,0,1604,0.63,"Quantrill, Cal",1477,14,24,1515,0.37
1324,01_152_NYY_SEA_22,"Tanaka, Masahiro",1582,8,0,1590,0.65,"Kikuchi, Yusei",1471,-12,24,1483,0.35
1325,01_153_STL_MIL_14,"Flaherty, Jack",1540,34,0,1574,0.58,"Lyles, Jordan",1507,-15,24,1516,0.42
1326,01_153_NYY_SEA_16,"Paxton, James",1583,12,0,1595,0.64,"Sheffield, Justus",1470,0,24,1494,0.36
1327,01_153_PIT_PHI_18,"Keller, Mitch",1476,-10,0,1466,0.42,"Velasquez, Vince",1507,-7,24,1524,0.58
1328,01_153_BAL_WSH_19,"Wojciechowski, Asher",1413,4,0,1417,0.24,"Scherzer, Max",1555,42,24,1621,0.76
1329,01_153_ATL_TOR_19,"Foltynewicz, Mike",1535,-2,0,1533,0.52,"Waguespack, Jacob",1473,21,24,1518,0.48
1330,01_153_CLE_DET_19,"Civale, Aaron",1555,-11,0,1544,0.68,"Zimmermann, Jordan",1397,-5,24,1416,0.32
1331,01_153_CIN_MIA_19,"DeSclafani, Anthony",1501,-6,0,1495,0.55,"Alcantara, Sandy",1436,3,24,1463,0.45
1332,01_153_CHC_NYM_19,"Hendricks, Kyle",1531,21,0,1552,0.49,"Syndergaard, Noah",1522,14,24,1560,0.51
1333,01_153_MIN_CHW_20,"Odorizzi, Jake",1541,9,0,1550,0.61,"Detwiler, Ross",1460,-15,24,1469,0.39
1334,01_153_TB_HOU_20,"Yarbrough, Ryan",1531,18,0,1549,0.36,"Cole, Gerrit",1588,35,24,1647,0.64
1335,01_153_OAK_KC_20,"Roark, Tanner",1547,2,0,1549,0.62,"Junis, Jakob",1429,12,24,1465,0.38
1336,01_153_BOS_COL_20,"Rodriguez, Eduardo",1546,17,0,1563,0.6,"Lambert, Peter",1489,-18,24,1495,0.4
1337,01_153_LAD_SD_21,"Maeda, Kenta",1589,-12,0,1577,0.6,Pitcher TBD,1479,6,24,1509,0.4
1338,01_153_TEX_LAA_22,"Jurado, Ariel",1468,-25,0,1443,0.41,"Sandoval, Patrick",1488,-10,24,1502,0.59
1339,01_154_CLE_DET_13,"Clevinger, Mike",1556,18,0,1574,0.7,"Norris, Daniel",1396,5,24,1425,0.3
1340,01_154_OAK_KC_13,"Bassitt, Chris",1545,7,0,1552,0.66,"Sparkman, Glenn",1431,-16,24,1439,0.34
1341,01_154_MIN_CHW_14,"Berrios, Jose",1542,6,0,1548,0.61,"Cease, Dylan",1458,-15,24,1467,0.39
1342,01_154_TB_HOU_14,"Kittredge, Andrew",1531,-23,0,1508,0.34,"Greinke, Zack",1589,12,24,1625,0.66
1343,01_154_CIN_MIA_19,"Wood, Alex",1503,-13,0,1490,0.57,"Dugger, Robert",1434,-17,24,1441,0.43
1344,01_154_CHC_NYM_19,"Lester, Jon",1532,-18,0,1514,0.39,"deGrom, Jacob",1521,47,24,1592,0.61
1345,01_154_SEA_TEX_20,"Hernandez, Felix",1467,-13,-4,1450,0.4,"Lynn, Lance",1468,34,21,1523,0.6
1346,01_154_PIT_COL_20,"Williams, Trevor",1473,1,-4,1470,0.47,"Gonzalez, Chi Chi",1488,-21,24,1491,0.53
1347,01_154_LAD_ARI_21,"Ryu, Hyun-Jin",1591,7,-2,1596,0.61,"Kelly, Merrill",1512,-15,23,1520,0.39
1348,01_154_SD_SF_21,"Paddack, Chris",1477,7,-2,1482,0.46,"Rodriguez, Dereck",1483,-2,26,1507,0.54
1349,01_155_MIL_CHC_14,"Anderson, Chase",1509,6,1,1516,0.44,"Quintana, Jose",1535,5,21,1561,0.56
1350,01_155_OAK_NYY_19,"Anderson, Brett",1546,-8,-3,1535,0.41,"Sabathia, CC",1586,-10,22,1598,0.59
1351,01_155_NYM_PHI_19,"Wheeler, Zack",1518,-4,-1,1513,0.41,"Nola, Aaron",1510,43,26,1579,0.59
1352,01_155_MIA_WSH_19,"Hernandez, Elieser",1435,-5,-3,1427,0.31,"Sanchez, Anibal",1556,-12,26,1570,0.69
1353,01_155_HOU_TOR_19,"Miley, Wade",1587,-11,-3,1573,0.62,"Thornton, Trent",1471,-5,26,1492,0.38
1354,01_155_MIN_DET_19,"Gibson, Kyle",1544,-3,-2,1539,0.69,"VerHagen, Drew",1396,-18,24,1402,0.31
1355,01_155_CLE_TB_19,"Bieber, Shane",1557,14,-3,1568,0.55,"Pruitt, Austin",1532,-21,21,1532,0.45
1356,01_155_CHW_ATL_19,"Nova, Ivan",1457,10,-3,1464,0.36,"Fried, Max",1537,2,23,1562,0.64
1357,01_155_SEA_TEX_20,"Gonzales, Marco",1468,21,0,1489,0.51,"Allard, Kolby",1468,-8,24,1484,0.49
1358,01_155_BAL_KC_20,"Means, John",1412,27,-1,1438,0.48,"Skoglund, Eric",1430,-5,24,1449,0.52
1359,01_155_CIN_STL_20,"Bauer, Trevor",1502,6,-3,1505,0.43,"Hudson, Dakota",1538,-7,24,1555,0.57
1360,01_155_PIT_COL_20,"Agrazal, Dario",1475,-7,0,1468,0.47,"Senzatela, Antonio",1486,-20,24,1490,0.53
1361,01_155_LAD_ARI_21,"Gonsolin, Tony",1592,-26,0,1566,0.52,"Gallen, Zac",1512,14,24,1550,0.48
1362,01_155_BOS_LAA_22,"Eovaldi, Nathan",1547,-5,-1,1541,0.58,"Suarez, Jose",1486,-30,26,1482,0.42
1363,01_155_SD_SF_22,"Lamet, Dinelson",1477,13,0,1490,0.43,"Bumgarner, Madison",1482,32,24,1538,0.57
1364,01_156_OAK_NYY_13,"Bailey, Homer",1549,-15,0,1534,0.4,"German, Domingo",1583,1,24,1608,0.6
1365,01_156_CIN_STL_13,"Bauer, Trevor",1502,6,-1,1507,0.43,"Hudson, Dakota",1538,-7,27,1558,0.57
1366,01_156_MIL_CHC_14,"Davies, Zach",1507,-7,0,1500,0.41,"Hamels, Cole",1537,1,24,1562,0.59
1367,01_156_HOU_TOR_15,"Valdez, Framber",1588,-39,0,1549,0.55,"Buchholz, Clay",1469,19,24,1512,0.45
1368,01_156_NYM_PHI_16,"Matz, Steven",1521,-10,0,1511,0.47,"Vargas, Jason",1506,4,24,1534,0.53
1369,01_156_MIN_DET_18,"Perez, Martin",1545,-19,0,1526,0.63,"Boyd, Matthew",1394,19,24,1437,0.37
1370,01_156_CLE_TB_18,"Plesac, Zach",1554,-24,0,1530,0.46,Pitcher TBD,1534,-2,24,1556,0.54
1371,01_156_MIA_WSH_19,"Lopez, Pablo",1435,9,0,1444,0.34,"Ross, Joe",1556,-23,24,1557,0.66
1372,01_156_BAL_KC_19,"Bundy, Dylan",1416,14,0,1430,0.5,"Lopez, Jorge",1426,-22,24,1428,0.5
1373,01_156_CIN_STL_19,"Gray, Sonny",1502,28,0,1530,0.48,"Wacha, Michael",1538,-22,24,1540,0.52
1374,01_156_CHW_ATL_19,"Lopez, Reynaldo",1456,7,0,1463,0.35,"Keuchel, Dallas",1538,6,24,1568,0.65
1375,01_156_SEA_TEX_20,Pitcher TBD,1467,5,0,1472,0.46,"Burke, Brock",1470,4,24,1498,0.54
1376,01_156_LAD_ARI_20,"Kershaw, Clayton",1589,12,0,1601,0.56,"Ray, Robbie",1515,18,24,1557,0.44
1377,01_156_PIT_COL_20,"Musgrove, Joe",1477,10,0,1487,0.47,"Melville, Tim",1484,-2,24,1506,0.53
1378,01_156_SD_SF_21,"Lucchesi, Joey",1477,13,0,1490,0.48,"Webb, Logan",1482,-5,24,1501,0.52
1379,01_156_BOS_LAA_21,Pitcher TBD,1547,-1,0,1546,0.57,"Peters, Dillon",1486,-14,24,1496,0.43
1380,01_157_OAK_NYY_13,"Manaea, Sean",1548,0,0,1548,0.43,"Happ, J.A.",1583,-10,24,1597,0.57
1381,01_157_CIN_STL_13,"Mahle, Tyler",1499,-20,0,1479,0.37,"Mikolas, Miles",1541,5,24,1570,0.63
1382,01_157_HOU_TOR_13,"Verlander, Justin",1587,42,0,1629,0.67,"Font, Wilmer",1471,13,24,1508,0.33
1383,01_157_MIN_DET_13,"Pineda, Michael",1543,10,0,1553,0.67,"Turnbull, Spencer",1396,9,24,1429,0.33
1384,01_157_CLE_TB_13,"Plutko, Adam",1553,-31,0,1522,0.41,"Morton, Charlie",1536,23,24,1583,0.59
1385,01_157_MIA_WSH_13,"Smith, Caleb",1433,7,0,1440,0.29,"Corbin, Patrick",1558,14,24,1596,0.71
1386,01_157_BAL_KC_14,"Brooks, Aaron",1415,-6,0,1409,0.43,"Duffy, Danny",1427,3,24,1454,0.57
1387,01_157_MIL_CHC_14,"Gonzalez, Gio",1509,-1,0,1508,0.41,"Darvish, Yu",1535,11,24,1570,0.59
1388,01_157_SEA_TEX_15,"Kikuchi, Yusei",1466,-16,0,1450,0.45,"Martin, Brett",1470,-13,24,1481,0.55
1389,01_157_PIT_COL_15,"Brault, Steven",1480,10,0,1490,0.48,Pitcher TBD,1481,-1,24,1504,0.52
1390,01_157_SD_SF_16,"Lauer, Eric",1477,-3,0,1474,0.42,"Samardzija, Jeff",1482,22,24,1528,0.58
1391,01_157_BOS_LAA_16,"Price, David",1545,7,0,1552,0.52,"Heaney, Andrew",1488,24,24,1536,0.48
1392,01_157_LAD_ARI_16,"Stripling, Ross",1586,-17,0,1569,0.55,"Young, Alex",1518,-7,24,1535,0.45
1393,01_157_CHW_ATL_17,"Giolito, Lucas",1454,40,0,1494,0.39,"Teheran, Julio",1540,10,24,1574,0.61
1394,01_157_NYM_PHI_19,"Stroman, Marcus",1523,-3,0,1520,0.51,"Eflin, Zach",1505,-17,24,1512,0.49
1395,01_157_CIN_STL_19,"Castillo, Luis",1499,19,0,1518,0.44,"Ponce de Leon, Daniel",1541,-6,24,1559,0.56
1396,01_158_TEX_NYY_13,"Minor, Mike",1467,35,-3,1499,0.33,"Tanaka, Masahiro",1584,11,24,1619,0.67
1397,01_158_NYM_WSH_13,"Syndergaard, Noah",1522,3,-2,1523,0.45,"Ross, Joe",1559,-24,24,1559,0.55
1398,01_158_MIN_DET_13,"Odorizzi, Jake",1545,12,0,1557,0.69,"Zimmermann, Jordan",1395,0,24,1419,0.31
1399,01_158_BAL_TB_13,"Wojciechowski, Asher",1414,2,-3,1413,0.28,"Yarbrough, Ryan",1538,19,24,1581,0.72
1400,01_158_TOR_ATL_13,"Waguespack, Jacob",1470,11,-3,1478,0.34,"Soroka, Mike",1541,27,24,1592,0.66
1401,01_158_PHI_CIN_14,"Smyly, Drew",1506,-12,-2,1492,0.46,"DeSclafani, Anthony",1500,-1,22,1521,0.54
1402,01_158_SF_STL_14,"Beede, Tyler",1480,-18,-4,1458,0.37,"Wainwright, Adam",1540,-12,24,1552,0.63
1403,01_158_SEA_CHC_14,"Sheffield, Justus",1469,-3,-3,1463,0.35,"Hendricks, Kyle",1533,14,24,1571,0.65
1404,01_158_HOU_MIL_16,"Cole, Gerrit",1588,34,-2,1620,0.62,"Houser, Adrian",1511,1,23,1535,0.38
1405,01_158_SD_ARI_16,"Quantrill, Cal",1479,4,-3,1480,0.44,"Leake, Mike",1517,-16,24,1525,0.56
1406,01_158_CHW_CLE_19,"Detwiler, Ross",1453,-11,-3,1439,0.33,"Civale, Aaron",1551,-9,21,1563,0.67
1407,01_158_COL_LAD_20,"Lambert, Peter",1479,-17,-3,1459,0.28,"Buehler, Walker",1587,19,22,1628,0.72
1408,01_159_BAL_TB_15,"Blach, Ty",1413,-20,0,1393,0.3,"Richards, Trevor",1538,-20,24,1542,0.7
1409,01_159_TEX_NYY_18,"Volquez, Edinson",1471,-17,0,1454,0.29,"Paxton, James",1580,9,24,1613,0.71
1410,01_159_PHI_CIN_18,"Velasquez, Vince",1509,-7,0,1502,0.52,"Sims, Lucas",1497,-30,24,1491,0.48
1411,01_159_BAL_TB_18,Pitcher TBD,1413,3,0,1416,0.3,Pitcher TBD,1538,-2,24,1560,0.7
1412,01_159_MIA_PIT_19,"Alcantara, Sandy",1432,4,0,1436,0.43,"Keller, Mitch",1482,-21,23,1484,0.57
1413,01_159_NYM_WSH_19,"deGrom, Jacob",1524,44,0,1568,0.43,"Scherzer, Max",1557,39,24,1620,0.57
1414,01_159_MIN_BOS_19,"Dobnak, Randy",1545,-15,-3,1527,0.45,"Porcello, Rick",1546,-9,22,1559,0.55
1415,01_159_CHW_CLE_19,"Cease, Dylan",1452,-24,0,1428,0.27,"Clevinger, Mike",1553,24,24,1601,0.73
1416,01_159_TOR_ATL_19,"Font, Wilmer",1469,16,0,1485,0.39,"Foltynewicz, Mike",1542,-3,24,1563,0.61
1417,01_159_HOU_MIL_19,"Greinke, Zack",1588,8,0,1596,0.61,"Lyles, Jordan",1510,-12,24,1522,0.39
1418,01_159_SF_STL_19,"Rodriguez, Dereck",1479,-5,0,1474,0.33,"Flaherty, Jack",1541,31,24,1596,0.67
1419,01_159_SEA_CHC_20,"Hernandez, Felix",1468,-14,0,1454,0.38,"Lester, Jon",1534,-18,24,1540,0.62
1420,01_159_DET_KC_20,"Norris, Daniel",1394,8,-3,1399,0.41,"Montgomery, Mike",1429,10,26,1465,0.59
1421,01_159_SD_ARI_21,"Bolanos, Ronald",1477,-1,0,1476,0.43,"Kelly, Merrill",1519,-14,24,1529,0.57
1422,01_159_LAA_OAK_22,"Barria, Jaime",1487,8,0,1495,0.37,"Fiers, Mike",1547,16,22,1585,0.63
1423,01_159_COL_LAD_22,"Gonzalez, Chi Chi",1478,-23,0,1455,0.31,"Urias, Julio",1589,-21,24,1592,0.69
1424,01_160_NYM_WSH_13,"Wheeler, Zack",1523,-4,0,1519,0.43,"Sanchez, Anibal",1557,-13,24,1568,0.57
1425,01_160_TEX_NYY_18,"Lynn, Lance",1470,33,0,1503,0.37,"Green, Chad",1582,-12,24,1594,0.63
1426,01_160_PHI_CIN_18,"Nola, Aaron",1511,44,0,1555,0.55,"Bauer, Trevor",1495,-2,24,1517,0.45
1427,01_160_MIA_PIT_19,"Dugger, Robert",1433,-8,0,1425,0.38,"Williams, Trevor",1480,4,24,1508,0.62
1428,01_160_MIN_BOS_19,"Berrios, Jose",1546,8,0,1554,0.46,"Rodriguez, Eduardo",1545,16,24,1585,0.54
1429,01_160_CHW_CLE_19,"Nova, Ivan",1453,7,0,1460,0.32,"Bieber, Shane",1551,17,24,1592,0.68
1430,01_160_SF_STL_19,"Bumgarner, Madison",1478,34,0,1512,0.45,"Wacha, Michael",1541,-22,24,1543,0.55
1431,01_160_DET_KC_20,"Jackson, Edwin",1394,-25,0,1369,0.36,"Junis, Jakob",1429,13,24,1466,0.64
1432,01_160_SD_ARI_21,"Paddack, Chris",1476,11,0,1487,0.4,"Gallen, Zac",1520,16,24,1560,0.6
1433,01_160_LAA_OAK_22,"Sandoval, Patrick",1487,-2,0,1485,0.38,"Roark, Tanner",1547,0,24,1571,0.62
1434,01_160_COL_LAD_22,"Senzatela, Antonio",1478,-19,0,1459,0.29,"Ryu, Hyun-Jin",1589,4,24,1617,0.71
1435,01_161_PHI_CIN_12,"Vargas, Jason",1509,-1,0,1508,0.44,"Gray, Sonny",1497,29,24,1550,0.56
1436,01_161_CHW_CLE_13,"Lopez, Reynaldo",1453,2,0,1455,0.37,"Plesac, Zach",1552,-26,24,1550,0.63
1437,01_161_DET_KC_13,"Boyd, Matthew",1393,19,0,1412,0.47,"Sparkman, Glenn",1430,-18,24,1436,0.53
1438,01_161_SF_STL_13,"Webb, Logan",1479,-1,0,1478,0.39,"Hudson, Dakota",1540,-7,24,1557,0.61
1439,01_161_LAA_OAK_15,"Suarez, Jose",1485,-29,0,1456,0.35,"Anderson, Brett",1550,-8,24,1566,0.65
1440,01_161_TEX_BAL_19,"Allard, Kolby",1469,-4,-2,1463,0.5,"Means, John",1415,28,23,1466,0.5
1441,01_161_MIA_PIT_19,"Hernandez, Elieser",1433,-2,0,1431,0.41,"Agrazal, Dario",1481,-8,24,1497,0.59
1442,01_161_MIN_BOS_19,"Perez, Martin",1544,-25,0,1519,0.43,"Eovaldi, Nathan",1547,-4,24,1567,0.57
1443,01_161_CHC_MIL_19,"Quintana, Jose",1536,6,1,1543,0.51,"Anderson, Chase",1512,0,26,1538,0.49
1444,01_161_TOR_TB_19,"Thornton, Trent",1468,-4,0,1464,0.38,"Pruitt, Austin",1537,-13,26,1550,0.62
1445,01_161_WSH_ATL_19,"Strasburg, Stephen",1555,21,-3,1573,0.5,"Fried, Max",1544,3,26,1573,0.5
1446,01_161_SEA_HOU_20,"Gonzales, Marco",1466,16,-1,1481,0.34,"Miley, Wade",1587,-12,23,1598,0.66
1447,01_162_TEX_BAL_19,"Burke, Brock",1470,6,0,1476,0.54,"Bundy, Dylan",1413,12,24,1449,0.46
1448,01_162_STL_PIT_19,"Mikolas, Miles",1543,3,-3,1543,0.54,"Musgrove, Joe",1479,11,24,1514,0.46
1449,01_162_NYY_BOS_19,"German, Domingo",1583,-1,0,1582,0.54,"Chacin, Jhoulys",1545,-18,24,1551,0.46
1450,01_162_ARI_CIN_19,"Ray, Robbie",1521,11,-2,1530,0.54,"Mahle, Tyler",1498,-16,24,1506,0.46
1451,01_162_KC_MIA_19,"Lopez, Jorge",1429,-21,-3,1405,0.42,"Lopez, Pablo",1435,5,21,1461,0.58
1452,01_162_PHI_NYM_19,"Eflin, Zach",1508,-13,-3,1492,0.44,"Matz, Steven",1525,-12,24,1537,0.56
1453,01_162_TOR_TB_19,"Buchholz, Clay",1467,21,0,1488,0.45,"McKay, Brendan",1538,-37,24,1525,0.55
1454,01_162_WSH_ATL_19,"Corbin, Patrick",1554,16,0,1570,0.5,"Keuchel, Dallas",1545,3,24,1572,0.5
1455,01_162_LAA_CHW_20,"Peters, Dillon",1484,-10,-4,1470,0.43,"Giolito, Lucas",1456,38,22,1516,0.57
1456,01_162_SEA_HOU_20,"Milone, Tommy",1466,-7,0,1459,0.35,"Valdez, Framber",1587,-46,24,1565,0.65
1457,01_162_CHC_MIL_20,"Hamels, Cole",1538,1,0,1539,0.51,"Davies, Zach",1510,-5,24,1529,0.49
1458,01_162_CLE_MIN_20,"Plutko, Adam",1548,-33,-3,1512,0.41,"Pineda, Michael",1546,11,21,1578,0.59
1459,01_162_DET_OAK_22,"Turnbull, Spencer",1394,7,-4,1397,0.28,"Bailey, Homer",1551,-12,24,1563,0.72
1460,01_162_SF_LAD_22,"Samardzija, Jeff",1477,19,-4,1492,0.32,"Kershaw, Clayton",1590,10,26,1626,0.68
1461,01_162_COL_SD_22,"Melville, Tim",1476,-7,1,1470,0.44,"Lamet, Dinelson",1475,12,24,1511,0.56
1462,01_163_NYY_BOS_16,"Happ, J.A.",1580,-7,0,1573,0.53,"Lakins, Travis",1548,-18,24,1554,0.47
1463,01_163_ARI_CIN_16,"Young, Alex",1522,-9,0,1513,0.46,"Castillo, Luis",1497,18,24,1539,0.54
1464,01_163_KC_MIA_18,"Duffy, Danny",1431,3,0,1434,0.46,"Smith, Caleb",1433,3,24,1460,0.54
1465,01_163_TOR_TB_18,"Kay, Anthony",1465,-3,0,1462,0.33,"Morton, Charlie",1540,24,24,1588,0.67
1466,01_163_TEX_BAL_19,"Hernandez, Jonathan",1471,-11,0,1460,0.55,"Brooks, Aaron",1412,-8,24,1428,0.45
1467,01_163_STL_PIT_19,"Wainwright, Adam",1540,-10,0,1530,0.51,"Brault, Steven",1482,14,24,1520,0.49
1468,01_163_LAA_CHW_19,"Heaney, Andrew",1485,22,0,1507,0.58,"Covey, Dylan",1455,-25,24,1454,0.42
1469,01_163_SEA_HOU_19,"Kikuchi, Yusei",1464,-14,0,1450,0.23,"Verlander, Justin",1588,50,24,1662,0.77
1470,01_163_CHC_MIL_19,"Darvish, Yu",1535,12,0,1547,0.52,"Gonzalez, Gio",1512,-1,24,1535,0.48
1471,01_163_CLE_MIN_19,"Civale, Aaron",1551,-13,0,1538,0.44,"Odorizzi, Jake",1543,10,24,1577,0.56
1472,01_163_PHI_NYM_19,"Smyly, Drew",1507,-10,0,1497,0.43,"Stroman, Marcus",1526,-4,24,1546,0.57
1473,01_163_WSH_ATL_19,"Voth, Austin",1553,-30,0,1523,0.42,"Teheran, Julio",1546,8,24,1578,0.58
1474,01_163_COL_SD_20,"Hoffman, Jeff",1476,-10,0,1466,0.44,"Lucchesi, Joey",1475,12,24,1511,0.56
1475,01_163_DET_OAK_21,"Zimmermann, Jordan",1394,2,0,1396,0.26,"Bassitt, Chris",1552,2,24,1578,0.74
1476,01_163_SF_LAD_21,"Beede, Tyler",1477,-16,0,1461,0.32,"Gonsolin, Tony",1590,-20,24,1594,0.68
1477,01_164_TEX_BAL_13,"Minor, Mike",1473,40,0,1513,0.61,"Wojciechowski, Asher",1411,4,24,1439,0.39
1478,01_164_ARI_CIN_13,"Leake, Mike",1524,-21,0,1503,0.48,"DeSclafani, Anthony",1495,-1,24,1518,0.52
1479,01_164_KC_MIA_13,"Montgomery, Mike",1433,11,0,1444,0.48,"Alcantara, Sandy",1430,5,24,1459,0.52
1480,01_164_PHI_NYM_13,"Velasquez, Vince",1510,-7,0,1503,0.42,"Syndergaard, Noah",1523,11,24,1558,0.58
1481,01_164_TOR_TB_13,"Waguespack, Jacob",1464,8,0,1472,0.38,"Glasnow, Tyler",1541,-5,24,1560,0.62
1482,01_164_WSH_ATL_13,"Scherzer, Max",1552,40,0,1592,0.5,"Soroka, Mike",1547,20,24,1591,0.5
1483,01_164_STL_PIT_13,"Flaherty, Jack",1543,35,0,1578,0.6,"Marvel, James",1479,1,24,1504,0.4
1484,01_164_LAA_CHW_14,"Barria, Jaime",1486,6,0,1492,0.55,"Cease, Dylan",1454,-18,24,1460,0.45
1485,01_164_SEA_HOU_14,"Hernandez, Felix",1464,-13,0,1451,0.24,"Cole, Gerrit",1589,37,24,1650,0.76
1486,01_164_CHC_MIL_14,"Lester, Jon",1534,-14,0,1520,0.47,"Houser, Adrian",1513,3,24,1540,0.53
1487,01_164_CLE_MIN_14,"Clevinger, Mike",1549,25,0,1574,0.53,"Dobnak, Randy",1544,-13,24,1555,0.47
1488,01_164_DET_OAK_16,"Norris, Daniel",1394,7,0,1401,0.26,"Manaea, Sean",1551,5,24,1580,0.74
1489,01_164_SF_LAD_16,"Rodriguez, Dereck",1480,0,0,1480,0.34,"Urias, Julio",1587,-19,24,1592,0.66
1490,01_164_COL_SD_16,"Lambert, Peter",1476,-24,0,1452,0.44,"Lauer, Eric",1475,-4,24,1495,0.56
1491,01_164_NYY_BOS_20,"Tanaka, Masahiro",1582,7,0,1589,0.55,"Porcello, Rick",1546,-16,24,1554,0.45
1492,01_165_ATL_PHI_19,"Foltynewicz, Mike",1545,-4,-3,1538,0.45,"Nola, Aaron",1512,39,23,1574,0.55
1493,01_165_NYY_BOS_19,"Paxton, James",1584,14,0,1598,0.52,"Rodriguez, Eduardo",1544,19,24,1587,0.48
1494,01_165_MIL_MIA_19,"Lyles, Jordan",1515,-11,-3,1501,0.57,"Dugger, Robert",1433,-9,24,1448,0.43
1495,01_165_ARI_NYM_19,"Kelly, Merrill",1523,-12,-3,1508,0.39,"deGrom, Jacob",1521,43,24,1588,0.61
1496,01_165_OAK_HOU_20,"Fiers, Mike",1552,9,-4,1557,0.41,"Greinke, Zack",1591,5,24,1620,0.59
1497,01_165_PIT_SF_21,"Williams, Trevor",1478,5,-4,1479,0.43,"Bumgarner, Madison",1479,30,22,1531,0.57
1498,01_165_CLE_LAA_22,"Bieber, Shane",1551,18,-4,1565,0.58,"Sandoval, Patrick",1484,1,20,1505,0.42
1499,01_165_CHC_SD_22,"Hendricks, Kyle",1533,19,-4,1548,0.58,"Quantrill, Cal",1476,-6,24,1494,0.42
1500,01_166_NYY_DET_18,Pitcher TBD,1586,1,-3,1584,0.75,"Jackson, Edwin",1394,-25,22,1391,0.25
1501,01_166_LAD_BAL_19,"Buehler, Walker",1588,15,-2,1601,0.74,"Blach, Ty",1409,-17,26,1418,0.26
1502,01_166_ATL_PHI_19,"Fried, Max",1547,8,0,1555,0.53,"Vargas, Jason",1509,1,24,1534,0.47
1503,01_166_BOS_TOR_19,"Eovaldi, Nathan",1542,-2,-2,1538,0.58,"Zeuch, T.J.",1462,-3,23,1482,0.42
1504,01_166_MIL_MIA_19,"Anderson, Chase",1517,-1,0,1516,0.6,"Hernandez, Elieser",1431,-9,24,1446,0.4
1505,01_166_ARI_NYM_19,"Gallen, Zac",1522,23,0,1545,0.5,"Wheeler, Zack",1522,-3,24,1543,0.5
1506,01_166_WSH_MIN_19,"Sanchez, Anibal",1554,-20,-1,1533,0.45,"Berrios, Jose",1543,2,26,1571,0.55
1507,01_166_TB_TEX_20,"Yarbrough, Ryan",1542,15,-1,1556,0.54,"Lynn, Lance",1475,32,23,1530,0.46
1508,01_166_KC_CHW_20,"Junis, Jakob",1430,14,-1,1443,0.44,"Nova, Ivan",1456,0,26,1482,0.56
1509,01_166_OAK_HOU_20,"Roark, Tanner",1548,6,0,1554,0.44,"Miley, Wade",1594,-22,24,1596,0.56
1510,01_166_STL_COL_20,"Wacha, Michael",1544,-24,-1,1519,0.56,"Gonzalez, Chi Chi",1475,-19,23,1479,0.44
1511,01_166_PIT_SF_21,"Keller, Mitch",1479,-15,0,1464,0.43,"Cueto, Johnny",1477,10,24,1511,0.57
1512,01_166_CLE_LAA_22,"Plesac, Zach",1551,-31,0,1520,0.56,"Suarez, Jose",1484,-28,24,1480,0.44
1513,01_166_CHC_SD_22,"Quintana, Jose",1533,5,0,1538,0.55,"Bolanos, Ronald",1476,1,24,1501,0.45
1514,01_166_CIN_SEA_22,"Bauer, Trevor",1496,-5,-2,1489,0.5,"Sheffield, Justus",1462,6,22,1490,0.5
1515,01_167_NYY_DET_18,"Sabathia, CC",1584,-12,0,1572,0.68,"Boyd, Matthew",1395,21,24,1440,0.32
1516,01_167_ATL_PHI_19,"Keuchel, Dallas",1546,5,0,1551,0.54,"Eflin, Zach",1511,-11,24,1524,0.46
1517,01_167_LAD_BAL_19,"Stripling, Ross",1589,-13,0,1576,0.66,"Means, John",1408,33,24,1465,0.34
1518,01_167_BOS_TOR_19,"Chacin, Jhoulys",1541,-15,0,1526,0.56,"Thornton, Trent",1464,-3,24,1485,0.44
1519,01_167_MIL_MIA_19,"Davies, Zach",1517,-3,0,1514,0.58,"Lopez, Pablo",1431,5,24,1460,0.42
1520,01_167_ARI_NYM_19,"Ray, Robbie",1521,10,0,1531,0.49,"Matz, Steven",1524,-12,24,1536,0.51
1521,01_167_WSH_MIN_19,"Strasburg, Stephen",1552,19,0,1571,0.54,"Perez, Martin",1545,-24,24,1545,0.46
1522,01_167_TB_TEX_20,Pitcher TBD,1543,0,0,1543,0.6,"Jurado, Ariel",1473,-28,24,1469,0.4
1523,01_167_CLE_LAA_20,"Plutko, Adam",1555,-32,0,1523,0.54,"Peters, Dillon",1480,-11,24,1493,0.46
1524,01_167_KC_CHW_20,"Sparkman, Glenn",1428,-21,0,1407,0.38,"Lopez, Reynaldo",1458,10,24,1492,0.62
1525,01_167_OAK_HOU_20,"Anderson, Brett",1553,-8,0,1545,0.47,"Valdez, Framber",1589,-47,24,1566,0.53
1526,01_167_STL_COL_20,"Hudson, Dakota",1543,-6,0,1537,0.58,"Senzatela, Antonio",1477,-23,24,1478,0.42
1527,01_167_PIT_SF_21,"Agrazal, Dario",1478,-17,0,1461,0.46,"Webb, Logan",1478,-15,24,1487,0.54
1528,01_167_CHC_SD_22,"Hamels, Cole",1535,-5,0,1530,0.52,"Paddack, Chris",1474,15,24,1513,0.48
1529,01_167_CIN_SEA_22,"Gray, Sonny",1496,31,0,1527,0.54,"Gonzales, Marco",1462,14,24,1500,0.46
1530,01_168_NYY_DET_13,"Happ, J.A.",1584,0,2,1586,0.7,"Boyd, Matthew",1395,21,26,1442,0.3
1531,01_168_MIL_MIA_13,"Gonzalez, Gio",1519,1,0,1520,0.59,"Smith, Caleb",1430,6,24,1460,0.41
1532,01_168_ARI_NYM_13,"Young, Alex",1518,7,0,1525,0.48,"Stroman, Marcus",1527,-10,24,1541,0.52
1533,01_168_KC_CHW_14,"Lopez, Jorge",1430,-16,0,1414,0.35,"Giolito, Lucas",1456,43,24,1523,0.65
1534,01_168_STL_COL_15,"Mikolas, Miles",1542,2,0,1544,0.57,"Melville, Tim",1478,-6,24,1496,0.43
1535,01_168_CHC_SD_15,"Darvish, Yu",1534,17,0,1551,0.56,"Lamet, Dinelson",1475,13,24,1512,0.44
1536,01_168_PIT_SF_15,"Musgrove, Joe",1480,12,0,1492,0.46,"Samardzija, Jeff",1476,17,24,1517,0.54
1537,01_168_BOS_TOR_19,"Chacin, Jhoulys",1538,-15,0,1523,0.52,"Buchholz, Clay",1467,20,24,1511,0.48
1538,01_168_LAD_BAL_19,"Hill, Rich",1586,0,0,1586,0.69,"Bundy, Dylan",1411,12,24,1447,0.31
1539,01_168_ATL_PHI_19,"Teheran, Julio",1547,11,0,1558,0.54,"Smyly, Drew",1509,-4,24,1529,0.46
1540,01_168_WSH_MIN_19,"Corbin, Patrick",1554,13,0,1567,0.51,"Gibson, Kyle",1543,-7,24,1560,0.49
1541,01_168_TB_TEX_20,"McKay, Brendan",1542,-29,0,1513,0.52,"Allard, Kolby",1475,-1,24,1498,0.48
1542,01_168_OAK_HOU_20,"Bailey, Homer",1555,-9,0,1546,0.34,"Verlander, Justin",1588,50,24,1662,0.66
1543,01_168_CIN_SEA_22,"Mahle, Tyler",1495,-21,0,1474,0.47,"Dunn, Justin",1463,7,24,1494,0.53
1544,01_169_PIT_CHC_16,"Brault, Steven",1482,11,-4,1489,0.43,"Lester, Jon",1533,-17,20,1536,0.57
1545,01_169_ATL_WSH_19,"Soroka, Mike",1545,18,-2,1561,0.42,"Scherzer, Max",1556,39,21,1616,0.58
1546,01_169_NYY_TOR_19,"Tanaka, Masahiro",1586,5,-2,1589,0.64,"Kay, Anthony",1465,2,24,1491,0.36
1547,01_169_MIN_CLE_19,"Odorizzi, Jake",1541,13,-3,1551,0.48,"Civale, Aaron",1556,-12,22,1566,0.52
1548,01_169_BAL_DET_19,"Brooks, Aaron",1410,-13,-2,1395,0.47,"Zimmermann, Jordan",1393,0,24,1417,0.53
1549,01_169_LAD_NYM_19,"Kershaw, Clayton",1587,5,-2,1590,0.54,"Syndergaard, Noah",1530,6,24,1560,0.46
1550,01_169_OAK_TEX_20,"Bassitt, Chris",1556,5,-2,1559,0.59,"Burke, Brock",1476,-3,24,1497,0.41
1551,01_169_HOU_KC_20,"Cole, Gerrit",1586,42,-3,1625,0.72,"Duffy, Danny",1433,7,22,1462,0.28
1552,01_169_MIL_STL_20,"Houser, Adrian",1519,5,-3,1521,0.45,"Wainwright, Adam",1544,-9,21,1556,0.55
1553,01_169_SD_COL_20,"Lucchesi, Joey",1476,14,-3,1487,0.5,"Hoffman, Jeff",1476,-11,24,1489,0.5
1554,01_169_CIN_ARI_21,"Castillo, Luis",1494,21,-3,1512,0.49,"Leake, Mike",1514,-16,20,1518,0.51
1555,01_169_TB_LAA_22,"Morton, Charlie",1541,25,-3,1563,0.55,"Heaney, Andrew",1479,25,26,1530,0.45
1556,01_169_CHW_SEA_22,"Covey, Dylan",1454,-27,-4,1423,0.42,"Kikuchi, Yusei",1465,-10,24,1479,0.58
1557,01_169_MIA_SF_22,"Alcantara, Sandy",1429,12,-4,1437,0.43,"Beede, Tyler",1475,-12,24,1487,0.57
1558,01_170_PIT_CHC_14,"Marvel, James",1479,6,0,1485,0.37,"Hendricks, Kyle",1536,19,24,1579,0.63
1559,01_170_NYY_TOR_15,"Paxton, James",1585,20,0,1605,0.66,"Waguespack, Jacob",1466,1,24,1491,0.34
1560,01_170_ATL_WSH_16,"Foltynewicz, Mike",1548,1,0,1549,0.5,"Voth, Austin",1554,-31,24,1547,0.5
1561,01_170_BAL_DET_18,"Ynoa, Gabriel",1412,-9,0,1403,0.47,"Norris, Daniel",1391,10,24,1425,0.53
1562,01_170_BOS_PHI_19,"Rodriguez, Eduardo",1539,22,0,1561,0.48,"Nola, Aaron",1511,37,26,1574,0.52
1563,01_170_MIN_CLE_19,Pitcher TBD,1541,0,-1,1540,0.45,Pitcher TBD,1556,-2,25,1579,0.55
1564,01_170_LAD_NYM_19,"Ryu, Hyun-Jin",1589,1,0,1590,0.49,"deGrom, Jacob",1527,43,24,1594,0.51
1565,01_170_HOU_KC_19,"Greinke, Zack",1587,9,0,1596,0.68,"Montgomery, Mike",1432,6,24,1462,0.32
1566,01_170_MIL_STL_19,"Lyles, Jordan",1516,-9,0,1507,0.36,"Flaherty, Jack",1547,37,24,1608,0.64
1567,01_170_OAK_TEX_20,"Fiers, Mike",1558,-1,0,1557,0.52,"Minor, Mike",1474,42,24,1540,0.48
1568,01_170_CIN_ARI_20,"DeSclafani, Anthony",1497,0,0,1497,0.46,"Kelly, Merrill",1513,-10,24,1527,0.54
1569,01_170_SD_COL_20,"Lauer, Eric",1475,0,0,1475,0.5,"Lambert, Peter",1477,-23,24,1478,0.5
1570,01_170_MIA_SF_21,"Dugger, Robert",1428,-11,0,1417,0.35,"Bumgarner, Madison",1475,29,24,1528,0.65
1571,01_170_TB_LAA_21,"Glasnow, Tyler",1541,-6,0,1535,0.53,"Barria, Jaime",1479,9,24,1512,0.47
1572,01_170_CHW_SEA_21,"Cease, Dylan",1454,-15,0,1439,0.46,"Hernandez, Felix",1462,-20,24,1466,0.54
1573,01_171_BOS_PHI_13,"Porcello, Rick",1540,-20,0,1520,0.48,"Vargas, Jason",1510,-2,24,1532,0.52
1574,01_171_NYY_TOR_13,"Montgomery, Jordan",1587,9,0,1596,0.66,"Zeuch, T.J.",1464,-5,24,1483,0.34
1575,01_171_MIN_CLE_13,"Berrios, Jose",1544,10,0,1554,0.44,"Bieber, Shane",1552,18,24,1594,0.56
1576,01_171_BAL_DET_13,"Wojciechowski, Asher",1410,1,0,1411,0.53,"Jackson, Edwin",1393,-29,24,1388,0.47
1577,01_171_ATL_WSH_13,"Fried, Max",1551,2,0,1553,0.49,"Sanchez, Anibal",1551,-16,24,1559,0.51
1578,01_171_HOU_KC_14,"Miley, Wade",1588,-31,0,1557,0.63,"Junis, Jakob",1431,10,24,1465,0.37
1579,01_171_MIL_STL_14,"Anderson, Chase",1519,-1,0,1518,0.46,"Wacha, Michael",1545,-24,24,1545,0.54
1580,01_171_PIT_CHC_14,"Williams, Trevor",1476,7,0,1483,0.39,"Quintana, Jose",1538,-1,24,1561,0.61
1581,01_171_OAK_TEX_15,"Manaea, Sean",1559,12,0,1571,0.59,Pitcher TBD,1473,10,24,1507,0.41
1582,01_171_SD_COL_15,"Quantrill, Cal",1474,-12,0,1462,0.46,"Gonzalez, Chi Chi",1478,-13,24,1489,0.54
1583,01_171_MIA_SF_16,"Hernandez, Elieser",1430,-7,0,1423,0.38,"Cueto, Johnny",1474,12,24,1510,0.62
1584,01_171_TB_LAA_16,"Yarbrough, Ryan",1544,19,0,1563,0.59,"Sandoval, Patrick",1475,1,24,1500,0.41
1585,01_171_CIN_ARI_16,"Bauer, Trevor",1497,-5,0,1492,0.4,"Gallen, Zac",1514,26,24,1564,0.6
1586,01_171_CHW_SEA_16,"Nova, Ivan",1454,1,0,1455,0.44,"Sheffield, Justus",1461,9,24,1494,0.56
1587,01_171_LAD_NYM_19,"Buehler, Walker",1588,19,0,1607,0.58,"Wheeler, Zack",1529,-3,24,1550,0.42
1588,01_172_BAL_DET_16,"Means, John",1413,35,0,1448,0.54,"Alexander, Tyler",1391,2,24,1417,0.46
1589,01_172_SD_MIL_19,"Richards, Garrett",1472,21,-3,1490,0.43,"Davies, Zach",1520,-4,22,1538,0.57
1590,01_172_CHW_MIN_19,"Lopez, Reynaldo",1453,6,-3,1456,0.33,"Berrios, Jose",1543,10,21,1574,0.67
1591,01_172_WSH_STL_19,"Strasburg, Stephen",1553,18,-3,1568,0.51,"Hudson, Dakota",1543,-6,24,1561,0.49
1592,01_172_CIN_CHC_20,"Gausman, Kevin",1498,-27,-4,1467,0.37,"Hamels, Cole",1541,-3,24,1562,0.63
1593,01_172_NYM_COL_20,"Matz, Steven",1528,-11,-4,1513,0.54,"Senzatela, Antonio",1480,-17,24,1487,0.46
1594,01_172_MIA_ARI_21,"Lopez, Pablo",1429,-1,-3,1425,0.34,"Ray, Robbie",1513,4,24,1541,0.66
1595,01_172_KC_OAK_22,"Sparkman, Glenn",1429,-20,-4,1405,0.26,"Roark, Tanner",1561,3,20,1584,0.74
1596,01_173_LAA_NYY_18,"Suarez, Jose",1477,-30,-2,1445,0.26,"Severino, Luis",1585,17,24,1626,0.74
1597,01_173_TOR_BAL_19,"Thornton, Trent",1466,-3,0,1463,0.54,"Shepherd, Chandler",1411,6,22,1439,0.46
1598,01_173_SEA_PIT_19,"Gonzales, Marco",1462,18,-2,1478,0.49,"Keller, Mitch",1474,-14,24,1484,0.51
1599,01_173_SF_BOS_19,"Webb, Logan",1474,-17,-2,1455,0.35,"Eovaldi, Nathan",1542,-6,24,1560,0.65
1600,01_173_DET_CLE_19,Pitcher TBD,1393,4,-1,1396,0.29,"Plutko, Adam",1553,-33,26,1546,0.71
1601,01_173_PHI_ATL_19,"Velasquez, Vince",1509,-10,-1,1498,0.38,"Keuchel, Dallas",1548,8,23,1579,0.62
1602,01_173_SD_MIL_19,"Paddack, Chris",1470,22,0,1492,0.39,"Woodruff, Brandon",1522,21,24,1567,0.61
1603,01_173_CHW_MIN_19,"Detwiler, Ross",1453,-12,0,1441,0.35,"Perez, Martin",1544,-23,24,1545,0.65
1604,01_173_WSH_STL_19,"Corbin, Patrick",1552,11,0,1563,0.49,"Mikolas, Miles",1545,0,24,1569,0.51
1605,01_173_CIN_CHC_20,"Gray, Sonny",1497,30,0,1527,0.41,"Darvish, Yu",1542,23,24,1589,0.59
1606,01_173_TEX_HOU_20,"Lynn, Lance",1472,39,0,1511,0.3,"Verlander, Justin",1590,47,23,1660,0.7
1607,01_173_NYM_COL_20,"Stroman, Marcus",1526,-9,0,1517,0.54,"Melville, Tim",1482,-14,24,1492,0.46
1608,01_173_MIA_ARI_21,"Smith, Caleb",1429,4,0,1433,0.36,"Young, Alex",1513,-3,24,1534,0.64
1609,01_173_KC_OAK_22,"Lopez, Jorge",1429,-16,0,1413,0.28,"Anderson, Brett",1561,-8,24,1577,0.72
1610,01_173_TB_LAD_22,"Snell, Blake",1543,20,1,1564,0.45,"Stripling, Ross",1589,-13,22,1598,0.55
1611,01_174_WSH_STL_13,"Scherzer, Max",1554,35,0,1589,0.54,"Wainwright, Adam",1543,-6,24,1561,0.46
1612,01_174_NYM_COL_15,"Syndergaard, Noah",1528,2,0,1530,0.55,"Hoffman, Jeff",1480,-11,24,1493,0.45
1613,01_174_KC_OAK_15,"Duffy, Danny",1430,11,0,1441,0.31,"Bailey, Homer",1559,-4,24,1579,0.69
1614,01_174_MIA_ARI_15,"Alcantara, Sandy",1428,12,0,1440,0.39,"Leake, Mike",1513,-18,24,1519,0.61
1615,01_174_LAA_NYY_18,"Peters, Dillon",1475,-15,0,1460,0.31,"Sabathia, CC",1587,-12,24,1599,0.69
1616,01_174_TOR_BAL_19,"Buchholz, Clay",1468,19,0,1487,0.56,"Bundy, Dylan",1409,14,24,1447,0.44
1617,01_174_SEA_PIT_19,"Dunn, Justin",1465,1,0,1466,0.47,"Agrazal, Dario",1471,-11,24,1484,0.53
1618,01_174_SF_BOS_19,"Samardzija, Jeff",1474,14,0,1488,0.41,"Chacin, Jhoulys",1542,-15,24,1551,0.59
1619,01_174_DET_CLE_19,"Turnbull, Spencer",1392,6,0,1398,0.27,"Civale, Aaron",1554,-12,24,1566,0.73
1620,01_174_PHI_ATL_19,"Eflin, Zach",1510,-12,0,1498,0.39,"Teheran, Julio",1547,5,24,1576,0.61
1621,01_174_SD_MIL_19,"Lamet, Dinelson",1469,14,0,1483,0.41,"Houser, Adrian",1523,-1,24,1546,0.59
1622,01_174_CHW_MIN_19,"Covey, Dylan",1452,-28,0,1424,0.29,"Odorizzi, Jake",1545,13,24,1582,0.71
1623,01_174_CIN_CHC_20,"Mahle, Tyler",1498,-27,0,1471,0.4,"Lester, Jon",1541,-21,24,1544,0.6
1624,01_174_TEX_HOU_20,"Allard, Kolby",1471,-3,0,1468,0.25,"Cole, Gerrit",1591,43,24,1658,0.75
1625,01_174_TB_LAD_20,"McKay, Brendan",1543,-29,0,1514,0.39,"Gonsolin, Tony",1589,-21,24,1592,0.61
1626,01_175_PHI_ATL_12,"Nola, Aaron",1512,39,0,1551,0.44,"Soroka, Mike",1545,23,24,1592,0.56
1627,01_175_SEA_PIT_12,"Kikuchi, Yusei",1467,-17,0,1450,0.41,"Musgrove, Joe",1470,20,24,1514,0.59
1628,01_175_SF_BOS_13,"Bumgarner, Madison",1479,28,0,1507,0.38,"Rodriguez, Eduardo",1537,27,24,1588,0.62
1629,01_175_SD_MIL_16,"Lucchesi, Joey",1470,7,0,1477,0.42,"Lyles, Jordan",1521,-9,24,1536,0.58
1630,01_175_LAA_NYY_18,"Heaney, Andrew",1477,16,0,1493,0.34,"Tanaka, Masahiro",1585,3,24,1612,0.66
1631,01_175_TOR_BAL_19,"Font, Wilmer",1469,17,0,1486,0.59,"Ynoa, Gabriel",1408,-10,24,1422,0.41
1632,01_175_DET_CLE_19,"Norris, Daniel",1391,12,0,1403,0.24,"Clevinger, Mike",1555,27,24,1606,0.76
1633,01_175_STL_CHC_19,"Flaherty, Jack",1545,35,-2,1578,0.49,"Hendricks, Kyle",1539,21,24,1584,0.51
1634,01_175_KC_MIN_19,"Montgomery, Mike",1429,5,-4,1430,0.33,"Gibson, Kyle",1543,-11,24,1556,0.67
1635,01_176_STL_CHC_14,"Wacha, Michael",1546,-23,0,1523,0.46,"Mills, Alec",1538,-12,24,1550,0.54
1636,01_176_PHI_CLE_19,"Smyly, Drew",1511,-5,-3,1503,0.37,"Bieber, Shane",1556,12,24,1592,0.63
1637,01_176_SEA_BAL_19,"Hernandez, Felix",1468,-14,-2,1452,0.52,"Bleier, Richard",1407,6,24,1437,0.48
1638,01_176_TOR_NYY_19,"Waguespack, Jacob",1470,0,-2,1468,0.31,"Happ, J.A.",1587,-3,24,1608,0.69
1639,01_176_NYM_CIN_19,"deGrom, Jacob",1529,46,-1,1574,0.55,"Castillo, Luis",1500,17,24,1541,0.45
1640,01_176_CHW_DET_19,"Cease, Dylan",1454,-9,-1,1444,0.55,"Zimmermann, Jordan",1390,-3,23,1410,0.45
1641,01_176_WSH_MIA_19,"Sanchez, Anibal",1552,-12,-1,1539,0.63,"Dugger, Robert",1431,-8,22,1445,0.37
1642,01_176_BOS_TB_19,"Porcello, Rick",1538,-18,-3,1517,0.4,"Morton, Charlie",1543,24,22,1589,0.6
1643,01_176_SF_ATL_19,"Beede, Tyler",1478,-10,-3,1465,0.35,"Foltynewicz, Mike",1546,6,24,1576,0.65
1644,01_176_LAA_HOU_20,"Barria, Jaime",1475,11,-3,1483,0.3,"Greinke, Zack",1591,9,26,1626,0.7
1645,01_176_PIT_MIL_20,"Brault, Steven",1468,2,-2,1468,0.39,"Anderson, Chase",1523,-1,24,1546,0.61
1646,01_176_KC_MIN_20,"Skoglund, Eric",1428,-10,0,1418,0.3,Pitcher TBD,1544,1,24,1569,0.7
1647,01_176_COL_LAD_22,"Lambert, Peter",1479,-23,-1,1455,0.28,"Kershaw, Clayton",1589,5,26,1620,0.72
1648,01_176_TEX_OAK_22,"Minor, Mike",1470,35,-2,1503,0.39,"Fiers, Mike",1560,-6,26,1580,0.61
1649,01_176_ARI_SD_22,"Kelly, Merrill",1511,-5,0,1506,0.53,"Lauer, Eric",1469,-5,20,1484,0.47
1650,01_177_TOR_NYY_13,"Zeuch, T.J.",1472,-4,0,1468,0.28,"Paxton, James",1585,19,24,1628,0.72
1651,01_177_STL_CHC_14,"Hudson, Dakota",1547,-6,0,1541,0.48,"Quintana, Jose",1537,-6,24,1555,0.52
1652,01_177_NYM_CIN_16,"Wheeler, Zack",1532,0,0,1532,0.51,"DeSclafani, Anthony",1497,2,24,1523,0.49
1653,01_177_CHW_DET_18,"Nova, Ivan",1457,-2,0,1455,0.55,"Alexander, Tyler",1388,9,24,1421,0.45
1654,01_177_WSH_MIA_18,"Strasburg, Stephen",1553,18,0,1571,0.67,"Yamamoto, Jordan",1430,-3,24,1451,0.33
1655,01_177_BOS_TB_18,"Lakins, Travis",1537,-13,0,1524,0.44,"Glasnow, Tyler",1543,-4,24,1563,0.56
1656,01_177_SEA_BAL_19,"Sheffield, Justus",1467,4,0,1471,0.55,"Wojciechowski, Asher",1408,2,24,1434,0.45
1657,01_177_PHI_CLE_19,"Vargas, Jason",1510,-3,0,1507,0.43,"Plesac, Zach",1557,-26,24,1555,0.57
1658,01_177_LAA_HOU_19,"Sandoval, Patrick",1475,7,0,1482,0.36,"Miley, Wade",1592,-31,24,1585,0.64
1659,01_177_PIT_MIL_19,"Marvel, James",1466,-1,0,1465,0.39,"Davies, Zach",1525,-3,24,1546,0.61
1660,01_177_KC_MIN_19,"Sparkman, Glenn",1428,-23,0,1405,0.27,"Berrios, Jose",1544,12,24,1580,0.73
1661,01_177_SF_ATL_19,"Cueto, Johnny",1477,13,0,1490,0.39,"Fried, Max",1547,-3,24,1568,0.61
1662,01_177_ARI_SD_20,"Weaver, Luke",1511,7,0,1518,0.56,"Quantrill, Cal",1469,-16,24,1477,0.44
1663,01_177_TEX_OAK_21,"Burke, Brock",1468,-10,0,1458,0.31,"Manaea, Sean",1562,14,24,1600,0.69
1664,01_177_COL_LAD_21,"Gonzalez, Chi Chi",1479,-11,0,1468,0.28,"Buehler, Walker",1589,19,24,1632,0.72
1665,01_178_SEA_BAL_13,"Gonzales, Marco",1468,22,0,1490,0.54,"Means, John",1407,32,24,1463,0.46
1666,01_178_TOR_NYY_13,"Thornton, Trent",1471,-2,0,1469,0.29,"Severino, Luis",1586,16,24,1626,0.71
1667,01_178_NYM_CIN_13,"Matz, Steven",1530,-18,0,1512,0.49,"Bauer, Trevor",1498,-2,24,1520,0.51
1668,01_178_CHW_DET_13,"Lopez, Reynaldo",1458,4,0,1462,0.54,"Boyd, Matthew",1386,21,24,1431,0.46
1669,01_178_WSH_MIA_13,"Voth, Austin",1554,-25,0,1529,0.6,"Lopez, Pablo",1428,2,24,1454,0.4
1670,01_178_BOS_TB_13,"Eovaldi, Nathan",1536,-11,0,1525,0.42,"Yarbrough, Ryan",1544,11,24,1579,0.58
1671,01_178_SF_ATL_13,"Webb, Logan",1475,-15,0,1460,0.34,"Keuchel, Dallas",1549,2,24,1575,0.66
1672,01_178_LAA_HOU_14,"Rodriguez, Jose",1477,3,0,1480,0.26,"Verlander, Justin",1589,48,24,1661,0.74
1673,01_178_PIT_MIL_14,"Williams, Trevor",1464,1,0,1465,0.35,"Woodruff, Brandon",1527,20,24,1571,0.65
1674,01_178_KC_MIN_14,"Lopez, Jorge",1432,-13,0,1419,0.33,"Perez, Martin",1540,-24,24,1540,0.67
1675,01_178_STL_CHC_14,"Mikolas, Miles",1548,-1,0,1547,0.45,"Darvish, Yu",1536,24,24,1584,0.55
1676,01_178_TEX_OAK_16,"Lynn, Lance",1467,40,0,1507,0.39,"Roark, Tanner",1564,-1,24,1587,0.61
1677,01_178_COL_LAD_16,"Senzatela, Antonio",1480,-15,0,1465,0.29,"Ryu, Hyun-Jin",1587,8,24,1619,0.71
1678,01_178_ARI_SD_16,"Ray, Robbie",1515,5,0,1520,0.52,"Richards, Garrett",1465,18,24,1507,0.48
1679,01_178_PHI_CLE_18,"Velasquez, Vince",1513,-8,0,1505,0.44,"Plutko, Adam",1554,-31,24,1547,0.56
1680,01_179_PHI_WSH_19,"Eflin, Zach",1510,-7,-2,1501,0.38,"Corbin, Patrick",1552,12,21,1585,0.62
1681,01_179_BAL_TOR_19,"Shepherd, Chandler",1409,2,-2,1409,0.37,"Buchholz, Clay",1470,11,22,1503,0.63
1682,01_179_MIA_NYM_19,"Smith, Caleb",1430,3,-3,1430,0.35,"Matz, Steven",1532,-17,21,1536,0.65
1683,01_179_BOS_TB_19,"Chacin, Jhoulys",1538,-18,0,1520,0.4,"Snell, Blake",1542,21,24,1587,0.6
1684,01_179_STL_ARI_21,"Wainwright, Adam",1549,-5,-4,1540,0.52,"Young, Alex",1513,-6,22,1529,0.48
1685,01_180_PHI_WSH_13,"Parker, Blake",1508,-9,0,1499,0.43,"Ross, Joe",1554,-29,24,1549,0.57
1686,01_180_MIL_CIN_18,"Houser, Adrian",1528,-1,0,1527,0.46,"Gray, Sonny",1497,30,26,1553,0.54
1687,01_180_MIN_DET_18,"Odorizzi, Jake",1541,16,-1,1556,0.68,"Turnbull, Spencer",1388,11,26,1425,0.32
1688,01_180_CHC_PIT_19,"Hendricks, Kyle",1535,18,0,1553,0.61,"Keller, Mitch",1463,-9,24,1478,0.39
1689,01_180_PHI_WSH_19,"Nola, Aaron",1508,35,0,1543,0.41,"Scherzer, Max",1554,33,24,1611,0.59
1690,01_180_BAL_TOR_19,"Bundy, Dylan",1408,16,0,1424,0.4,"Kay, Anthony",1470,2,24,1496,0.6
1691,01_180_MIA_NYM_19,"Alcantara, Sandy",1433,10,0,1443,0.35,"Syndergaard, Noah",1529,-1,24,1552,0.65
1692,01_180_NYY_TB_19,Pitcher TBD,1587,9,-1,1595,0.58,"McKay, Brendan",1544,-27,24,1541,0.42
1693,01_180_CLE_CHW_20,"Clevinger, Mike",1557,27,0,1584,0.67,"Santiago, Hector",1456,-17,24,1463,0.33
1694,01_180_BOS_TEX_20,"Rodriguez, Eduardo",1537,30,-3,1564,0.62,"Volquez, Edinson",1470,-12,22,1480,0.38
1695,01_180_ATL_KC_20,"Teheran, Julio",1547,2,-1,1548,0.6,"Duffy, Danny",1431,19,24,1474,0.4
1696,01_180_STL_ARI_21,"Flaherty, Jack",1549,39,0,1588,0.6,"Leake, Mike",1513,-19,24,1518,0.4
1697,01_180_COL_SF_21,"Hoffman, Jeff",1479,-8,0,1471,0.42,"Bumgarner, Madison",1477,25,22,1524,0.58
1698,01_180_OAK_LAA_22,"Bailey, Homer",1561,2,0,1563,0.61,"Peters, Dillon",1476,-11,23,1488,0.39
1699,01_180_LAD_SD_22,"Hill, Rich",1588,-1,1,1588,0.64,"Bolanos, Ronald",1466,-4,26,1488,0.36
1700,01_180_HOU_SEA_22,"Cole, Gerrit",1591,45,-2,1634,0.7,"Dunn, Justin",1466,2,22,1490,0.3
1701,01_181_STL_ARI_15,"Wacha, Michael",1551,-21,0,1530,0.49,"Kelly, Merrill",1512,1,24,1537,0.51
1702,01_181_MIL_CIN_18,"Lyles, Jordan",1530,-9,0,1521,0.54,"Mahle, Tyler",1495,-24,24,1495,0.46
1703,01_181_MIN_DET_18,"Gibson, Kyle",1542,-13,0,1529,0.64,"Norris, Daniel",1388,15,24,1427,0.36
1704,01_181_NYY_TB_19,Pitcher TBD,1586,11,0,1597,0.5,"Morton, Charlie",1545,26,24,1595,0.5
1705,01_181_CHC_PIT_19,"Lester, Jon",1531,-21,0,1510,0.55,"Agrazal, Dario",1467,-12,24,1479,0.45
1706,01_181_PHI_WSH_19,"Smyly, Drew",1506,-8,0,1498,0.4,"Sanchez, Anibal",1556,-15,24,1565,0.6
1707,01_181_BAL_TOR_19,"Ynoa, Gabriel",1411,-10,0,1401,0.37,"Waguespack, Jacob",1467,3,24,1494,0.63
1708,01_181_MIA_NYM_19,"Dugger, Robert",1432,-8,0,1424,0.26,"deGrom, Jacob",1530,51,24,1605,0.74
1709,01_181_BOS_TEX_20,"Porcello, Rick",1538,-11,0,1527,0.55,"Allard, Kolby",1469,1,24,1494,0.45
1710,01_181_CLE_CHW_20,"Bieber, Shane",1559,14,0,1573,0.65,"Detwiler, Ross",1454,-13,24,1465,0.35
1711,01_181_ATL_KC_20,"Tomlin, Josh",1545,-24,0,1521,0.59,"Montgomery, Mike",1433,3,24,1460,0.41
1712,01_181_COL_SF_21,"Melville, Tim",1479,-13,0,1466,0.43,"Samardzija, Jeff",1477,15,24,1516,0.57
1713,01_181_OAK_LAA_22,Pitcher TBD,1559,4,0,1563,0.56,"Heaney, Andrew",1477,16,24,1517,0.44
1714,01_181_LAD_SD_22,"Stripling, Ross",1588,-10,0,1578,0.6,"Lamet, Dinelson",1466,17,24,1507,0.4
1715,01_181_HOU_SEA_22,"Greinke, Zack",1591,8,0,1599,0.67,"Kikuchi, Yusei",1466,-19,24,1471,0.33
1716,01_182_MIL_CIN_12,"Anderson, Chase",1532,1,0,1533,0.5,"Castillo, Luis",1493,19,24,1536,0.5
1717,01_182_MIN_DET_13,Pitcher TBD,1543,6,0,1549,0.7,"Zimmermann, Jordan",1386,-11,24,1399,0.3
1718,01_182_BOS_TEX_14,"Johnson, Brian",1540,-22,0,1518,0.49,"Minor, Mike",1466,32,24,1522,0.51
1719,01_182_LAD_SD_15,"Kershaw, Clayton",1589,2,0,1591,0.63,"Lucchesi, Joey",1465,6,24,1495,0.37
1720,01_182_COL_SF_15,"Freeland, Kyle",1481,3,0,1484,0.5,"Beede, Tyler",1475,-12,24,1487,0.5
1721,01_182_PHI_WSH_16,"Vargas, Jason",1505,-1,0,1504,0.36,"Strasburg, Stephen",1557,19,24,1600,0.64
1722,01_182_CHC_PIT_19,"Quintana, Jose",1530,-10,0,1520,0.51,"Musgrove, Joe",1468,19,24,1511,0.49
1723,01_182_MIA_NYM_19,"Yamamoto, Jordan",1431,-2,0,1429,0.32,"Wheeler, Zack",1531,4,24,1559,0.68
1724,01_182_CLE_CHW_20,"Civale, Aaron",1556,-6,0,1550,0.6,"Cease, Dylan",1457,-2,24,1479,0.4
1725,01_182_HOU_LAA_22,"Miley, Wade",1592,-38,-3,1551,0.56,"Barria, Jaime",1477,5,24,1506,0.44
1726,01_182_OAK_SEA_22,"Manaea, Sean",1559,14,-3,1570,0.64,"Hernandez, Felix",1465,-19,24,1470,0.36
1727,01_183_DET_CHW_16,"Alexander, Tyler",1385,3,-2,1386,0.36,"Nova, Ivan",1461,0,24,1485,0.64
1728,01_183_MIA_PHI_19,"Lopez, Pablo",1433,1,-1,1433,0.38,"Velasquez, Vince",1504,-6,22,1520,0.62
1729,01_183_CIN_PIT_19,"DeSclafani, Anthony",1491,8,-2,1497,0.51,"Brault, Steven",1470,-1,24,1493,0.49
1730,01_183_CLE_WSH_19,"Plesac, Zach",1552,-26,-3,1523,0.45,"Voth, Austin",1558,-26,24,1556,0.55
1731,01_183_TB_TOR_19,"Glasnow, Tyler",1547,-1,-1,1545,0.56,"Zeuch, T.J.",1471,3,26,1500,0.44
1732,01_183_BAL_BOS_19,"Wojciechowski, Asher",1407,1,0,1408,0.31,"Eovaldi, Nathan",1539,-10,20,1549,0.69
1733,01_183_ATL_NYM_19,"Keuchel, Dallas",1547,3,-1,1549,0.5,"Stroman, Marcus",1529,-4,24,1549,0.5
1734,01_183_DET_CHW_19,Pitcher TBD,1385,12,0,1397,0.36,Pitcher TBD,1461,10,24,1495,0.64
1735,01_183_CHC_STL_20,"Mills, Alec",1528,-5,-3,1520,0.44,"Hudson, Dakota",1548,-8,23,1563,0.56
1736,01_183_NYY_TEX_20,"Paxton, James",1584,21,-1,1604,0.68,"Palumbo, Joe",1468,-21,24,1471,0.32
1737,01_183_MIL_COL_20,"Davies, Zach",1533,-3,-3,1527,0.56,"Senzatela, Antonio",1478,-16,21,1483,0.44
1738,01_183_MIN_KC_20,"Berrios, Jose",1544,10,-3,1551,0.64,"Skoglund, Eric",1431,-6,26,1451,0.36
1739,01_183_SD_ARI_21,"Lauer, Eric",1463,-2,-2,1459,0.42,"Clarke, Taylor",1515,-27,26,1514,0.58
1740,01_183_HOU_LAA_22,"Urquidy, Jose",1592,-31,0,1561,0.58,"Sandoval, Patrick",1477,6,24,1507,0.42
1741,01_183_OAK_SEA_22,"Fiers, Mike",1561,1,0,1562,0.6,"Sheffield, Justus",1464,2,24,1490,0.4
1742,01_183_LAD_SF_22,"Buehler, Walker",1591,16,-2,1605,0.63,"Cueto, Johnny",1478,9,24,1511,0.37
1743,01_184_BAL_BOS_13,"Means, John",1410,34,0,1444,0.36,"Chacin, Jhoulys",1536,-19,24,1541,0.64
1744,01_184_MIN_KC_14,"Stashak, Cody",1545,-16,0,1529,0.64,"Sparkman, Glenn",1430,-21,24,1433,0.36
1745,01_184_TB_TOR_15,"Yarbrough, Ryan",1548,3,0,1551,0.58,"Thornton, Trent",1469,-1,24,1492,0.42
1746,01_184_DET_CHW_15,"Boyd, Matthew",1385,17,0,1402,0.38,"Lopez, Reynaldo",1461,-1,26,1486,0.62
1747,01_184_LAD_SF_16,"Ryu, Hyun-Jin",1591,8,0,1599,0.64,"Webb, Logan",1478,-7,24,1495,0.36
1748,01_184_CLE_WSH_16,"Plutko, Adam",1550,-29,0,1521,0.39,"Corbin, Patrick",1561,11,24,1596,0.61
1749,01_184_MIA_PHI_18,"Smith, Caleb",1433,1,0,1434,0.38,"Eflin, Zach",1505,-11,24,1518,0.62
1750,01_184_CIN_PIT_19,"Sims, Lucas",1490,-29,0,1461,0.46,"Marvel, James",1471,-9,24,1486,0.54
1751,01_184_ATL_NYM_19,"Foltynewicz, Mike",1546,13,0,1559,0.54,"Matz, Steven",1530,-23,24,1531,0.46
1752,01_184_CHC_STL_19,"Hamels, Cole",1531,-5,0,1526,0.45,"Wainwright, Adam",1545,-9,24,1560,0.55
1753,01_184_NYY_TEX_20,"Severino, Luis",1586,21,0,1607,0.69,"Farrell, Luke",1466,-25,24,1465,0.31
1754,01_184_SD_ARI_20,"Richards, Garrett",1462,12,0,1474,0.4,"Ray, Robbie",1516,5,24,1545,0.6
1755,01_184_MIL_COL_20,"Gonzalez, Gio",1531,-5,0,1526,0.55,"Gonzalez, Chi Chi",1480,-10,24,1494,0.45
1756,01_184_HOU_LAA_21,"Verlander, Justin",1593,42,0,1635,0.72,"Suarez, Jose",1476,-29,24,1471,0.28
1757,01_184_OAK_SEA_21,"Anderson, Brett",1561,-8,0,1553,0.56,"Gonzales, Marco",1464,23,24,1511,0.44
1758,01_185_BAL_BOS_15,"Shepherd, Chandler",1413,-10,0,1403,0.26,"Rodriguez, Eduardo",1533,24,24,1581,0.74
1759,01_185_MIA_PHI_15,"Alcantara, Sandy",1431,14,0,1445,0.38,"Parker, Blake",1506,-4,24,1526,0.62
1760,01_185_CIN_PIT_15,"Mahle, Tyler",1492,-31,0,1461,0.45,"Williams, Trevor",1470,0,24,1494,0.55
1761,01_185_LAD_SF_15,"Hill, Rich",1594,-2,0,1592,0.64,"Rodriguez, Dereck",1476,-5,24,1495,0.36
1762,01_185_NYY_TEX_15,"Green, Chad",1582,-13,0,1569,0.55,"Lynn, Lance",1470,42,24,1536,0.45
1763,01_185_CLE_WSH_15,"Clevinger, Mike",1549,33,0,1582,0.54,"Ross, Joe",1562,-29,24,1557,0.46
1764,01_185_HOU_LAA_15,"Cole, Gerrit",1593,47,0,1640,0.71,"Peters, Dillon",1475,-11,24,1488,0.29
1765,01_185_TB_TOR_15,"Snell, Blake",1546,17,0,1563,0.59,"Buchholz, Clay",1471,4,24,1499,0.41
1766,01_185_SD_ARI_15,"Baez, Michel",1461,-2,0,1459,0.39,"Walker, Taijuan",1517,-6,24,1535,0.61
1767,01_185_DET_CHW_15,"Turnbull, Spencer",1385,13,0,1398,0.4,"Detwiler, Ross",1461,-14,24,1471,0.6
1768,01_185_MIL_COL_15,"Houser, Adrian",1530,-1,0,1529,0.55,"Hoffman, Jeff",1481,-12,24,1493,0.45
1769,01_185_ATL_NYM_15,"Soroka, Mike",1544,24,0,1568,0.53,"Syndergaard, Noah",1532,-7,24,1549,0.47
1770,01_185_OAK_SEA_15,"Roark, Tanner",1561,-10,0,1551,0.58,"Dunn, Justin",1464,5,24,1493,0.42
1771,01_185_MIN_KC_15,"Perez, Martin",1546,-29,0,1517,0.62,"Lopez, Jorge",1429,-19,24,1434,0.38
1772,01_185_CHC_STL_15,"Holland, Derek",1532,-23,0,1509,0.36,"Flaherty, Jack",1544,45,24,1613,0.64
1773,01_187_MIL_WSH_20,"Woodruff, Brandon",1529,17,-2,1544,0.36,"Scherzer, Max",1565,30,26,1621,0.64
1774,01_188_TB_OAK_20,"Morton, Charlie",1544,30,1,1575,0.45,"Manaea, Sean",1559,15,26,1600,0.55
1775,01_189_STL_ATL_17,"Mikolas, Miles",1546,0,5,1551,0.46,"Keuchel, Dallas",1543,0,28,1571,0.54
1776,01_189_WSH_LAD_20,"Corbin, Patrick",1566,6,-2,1570,0.37,"Buehler, Walker",1596,13,29,1638,0.63
1777,01_190_TB_HOU_14,"Glasnow, Tyler",1547,2,-2,1547,0.29,"Verlander, Justin",1594,41,28,1663,0.71
1778,01_190_STL_ATL_16,"Flaherty, Jack",1547,48,0,1595,0.54,"Foltynewicz, Mike",1541,11,24,1576,0.46
1779,01_190_MIN_NYY_19,"Berrios, Jose",1545,11,4,1560,0.38,"Paxton, James",1580,18,28,1626,0.62
1780,01_190_WSH_LAD_21,"Strasburg, Stephen",1563,21,0,1584,0.42,"Kershaw, Clayton",1599,4,24,1627,0.58
1781,01_191_MIN_NYY_17,"Dobnak, Randy",1542,3,0,1545,0.37,"Tanaka, Masahiro",1582,6,24,1612,0.63
1782,01_191_TB_HOU_21,"Snell, Blake",1545,14,0,1559,0.31,"Cole, Gerrit",1596,45,24,1665,0.69
1783,01_192_ATL_STL_16,"Soroka, Mike",1544,20,0,1564,0.52,"Wainwright, Adam",1545,-18,24,1551,0.48
1784,01_192_LAD_WSH_19,"Ryu, Hyun-Jin",1596,10,-2,1604,0.52,Pitcher TBD,1566,5,22,1593,0.48
1785,01_193_HOU_TB_13,"Greinke, Zack",1597,9,-1,1605,0.52,"Morton, Charlie",1544,29,23,1596,0.48
1786,01_193_ATL_STL_15,Pitcher TBD,1546,-1,0,1545,0.47,"Hudson, Dakota",1543,-6,24,1561,0.53
1787,01_193_LAD_WSH_18,"Hill, Rich",1599,-3,0,1596,0.47,"Scherzer, Max",1562,24,24,1610,0.53
1788,01_193_NYY_MIN_20,"Severino, Luis",1585,19,-1,1603,0.54,"Odorizzi, Jake",1540,19,23,1582,0.46
1789,01_194_HOU_TB_19,"Verlander, Justin",1592,43,0,1635,0.66,"Castillo, Diego",1549,-23,24,1550,0.34
1790,01_195_STL_ATL_17,"Flaherty, Jack",1544,45,0,1589,0.51,"Foltynewicz, Mike",1544,16,24,1584,0.49
1791,01_195_WSH_LAD_20,"Strasburg, Stephen",1566,23,-2,1587,0.41,"Buehler, Walker",1596,17,22,1635,0.59
1792,01_196_TB_HOU_19,"Glasnow, Tyler",1552,0,-1,1551,0.3,"Cole, Gerrit",1589,51,23,1663,0.7
1793,01_197_WSH_STL_20,"Sanchez, Anibal",1569,-12,-2,1555,0.47,"Mikolas, Miles",1550,0,24,1574,0.53
1794,01_198_WSH_STL_16,"Scherzer, Max",1572,25,0,1597,0.57,"Wainwright, Adam",1548,-13,24,1559,0.43
1795,01_198_NYY_HOU_20,"Tanaka, Masahiro",1587,9,4,1600,0.46,"Greinke, Zack",1590,3,26,1619,0.54
1796,01_199_NYY_HOU_20,"Paxton, James",1592,15,0,1607,0.43,"Verlander, Justin",1586,35,24,1645,0.57
1797,01_200_STL_WSH_19,"Flaherty, Jack",1546,44,-1,1589,0.45,"Strasburg, Stephen",1573,18,23,1614,0.55
1798,01_201_HOU_NYY_16,"Cole, Gerrit",1587,52,-1,1638,0.51,"Severino, Luis",1591,19,23,1633,0.49
1799,01_201_STL_WSH_20,"Hudson, Dakota",1542,-10,0,1532,0.37,"Corbin, Patrick",1577,2,24,1603,0.63
1800,01_202_HOU_NYY_20,Pitcher TBD,1590,-26,0,1564,0.4,Pitcher TBD,1588,4,24,1616,0.6
1801,01_203_HOU_NYY_20,"Greinke, Zack",1590,1,2,1593,0.43,"Tanaka, Masahiro",1588,14,26,1628,0.57
1802,01_204_HOU_NYY_19,"Verlander, Justin",1593,33,0,1626,0.51,"Paxton, James",1584,14,24,1622,0.49
1803,01_205_NYY_HOU_20,Pitcher TBD,1587,3,-3,1587,0.5,Pitcher TBD,1591,-26,21,1586,0.5
1804,01_206_NYY_HOU_19,Pitcher TBD,1585,17,0,1602,0.44,Pitcher TBD,1593,16,24,1633,0.56
1805,01_208_WSH_HOU_20,"Scherzer, Max",1579,28,4,1611,0.38,"Cole, Gerrit",1593,53,29,1675,0.62
1806,01_209_WSH_HOU_20,"Strasburg, Stephen",1581,20,0,1601,0.41,"Verlander, Justin",1591,34,24,1649,0.59
1807,01_211_HOU_WSH_20,"Greinke, Zack",1585,2,-1,1586,0.47,"Sanchez, Anibal",1586,-9,23,1600,0.53
1808,01_212_HOU_WSH_20,"Urquidy, Jose",1588,-25,0,1563,0.41,"Corbin, Patrick",1584,1,24,1609,0.59
1809,01_213_HOU_WSH_20,"Cole, Gerrit",1593,48,0,1641,0.52,"Scherzer, Max",1579,28,24,1631,0.48
1810,01_215_WSH_HOU_20,"Strasburg, Stephen",1576,22,-1,1597,0.41,"Verlander, Justin",1595,29,23,1647,0.59
1811,01_216_WSH_HOU_20,"Scherzer, Max",1580,28,0,1608,0.48,"Greinke, Zack",1591,1,24,1616,0.52
